字頻序號,字,部首,筆畫,出現頻次,累積頻次,出現百分比,累積百分比
1,的,白,8,48957,48957,4.05616677,4.05616677
2,一,一,1,19931,68888,1.65131564,5.70748241
3,是,日,9,15244,84132,1.26299010,6.97047251
4,了,そ,2,12783,96915,1.05909226,8.02956477
5,不,一,4,12200,109115,1.01078977,9.04035454
6,我,戈,7,11919,121034,0.98750846,10.02786300
7,有,月,6,11588,132622,0.96008457,10.98794757
8,在,土,6,10160,142782,0.84177246,11.82972003
9,人,人,2,9173,151955,0.75999791,12.58971794
10,來,人,8,8247,160202,0.68327731,13.27299525
11,大,大,3,7963,168165,0.65974745,13.93274270
12,上,一,3,7065,175230,0.58534670,14.51808940
13,這,ひ,11,6914,182144,0.57283610,15.09092550
14,到,刀,8,6850,188994,0.56753360,15.65845910
15,們,人,10,6667,195661,0.55237175,16.21083085
16,個,人,10,6428,202089,0.53257021,16.74340106
17,小,小,3,6187,208276,0.51260297,17.25600403
18,你,人,7,6161,214437,0.51044883,17.76645286
19,子,子,3,6159,220596,0.51028313,18.27673599
20,他,人,5,6079,226675,0.50365500,18.78039099
21,以,人,5,6009,232684,0.49785539,19.27824638
22,好,女,6,5553,238237,0.46007505,19.73832143
23,為,火,9,5521,243758,0.45742380,20.19574523
24,就,尢,12,5516,249274,0.45700954,20.65275477
25,生,生,5,5444,254718,0.45104422,21.10379899
26,要,襾,9,5394,260112,0.44690164,21.55070063
27,說,言,14,5369,265481,0.44483035,21.99553098
28,中,｜,4,5339,270820,0.44234480,22.43787578
29,天,大,4,5317,276137,0.44052206,22.87839784
30,和,口,8,5193,281330,0.43024846,23.30864630
31,時,日,10,5116,286446,0.42386889,23.73251519
32,可,口,5,4993,291439,0.41367814,24.14619333
33,麼,麻,14,4864,296303,0.40299028,24.54918361
34,看,目,9,4786,301089,0.39652785,24.94571146
35,會,曰,13,4776,305865,0.39569934,25.34141080
36,地,土,6,4773,310638,0.39545078,25.73686158
37,家,で,10,4707,315345,0.38998258,26.12684416
38,下,一,3,4670,320015,0.38691707,26.51376123
39,出,凵,5,4639,324654,0.38434867,26.89810990
40,學,子,16,4470,329124,0.37034674,27.26845664
41,著,艸,12,4398,333522,0.36438143,27.63283807
42,國,囗,11,4185,337707,0.34673403,27.97957210
43,得,彳,11,4150,341857,0.34383422,28.32340632
44,也,乙,3,4074,345931,0.33753750,28.66094382
45,用,用,5,4033,349964,0.33414058,28.99508440
46,多,夕,6,3981,353945,0.32983230,29.32491670
47,成,戈,6,3812,357757,0.31583038,29.64074708
48,年,干,6,3679,361436,0.30481111,29.94555819
49,裡,衣,13,3636,365072,0.30124849,30.24680668
50,過,ひ,13,3413,368485,0.28277258,30.52957926
51,去,づ,5,3405,371890,0.28210977,30.81168903
52,能,肉,10,3396,375286,0.28136410,31.09305313
53,後,彳,9,3385,378671,0.28045273,31.37350586
54,長,長,8,3374,382045,0.27954137,31.65304723
55,都,邑,11,3370,385415,0.27920996,31.93225719
56,分,刀,4,3288,388703,0.27241613,32.20467332
57,很,彳,9,3229,391932,0.26752788,32.47220120
58,老,老,6,3079,395011,0.25510014,32.72730134
59,動,力,11,3057,398068,0.25327740,32.98057874
60,起,走,10,3046,401114,0.25236604,33.23294478
61,物,牛,8,3038,404152,0.25170322,33.48464800
62,公,八,4,3031,407183,0.25112326,33.73577126
63,水,水,4,2919,410102,0.24184388,33.97761514
64,什,人,4,2918,413020,0.24176103,34.21937617
65,心,心,4,2866,415886,0.23745274,34.45682891
66,把,手,7,2842,418728,0.23546430,34.69229321
67,面,面,9,2838,421566,0.23513290,34.92742611
68,作,人,7,2834,424400,0.23480149,35.16222760
69,方,方,4,2814,427214,0.23314446,35.39537206
70,那,邑,7,2755,429969,0.22825621,35.62362827
71,十,十,2,2728,432697,0.22601922,35.84964749
72,想,心,13,2695,435392,0.22328512,36.07293261
73,樣,木,15,2646,438038,0.21922539,36.29215800
74,自,自,6,2637,440675,0.21847972,36.51063772
75,所,戶,8,2587,443262,0.21433714,36.72497486
76,然,火,12,2585,445847,0.21417144,36.93914630
77,如,女,6,2564,448411,0.21243155,37.15157785
78,三,一,3,2543,450954,0.21069167,37.36226952
79,發,ぱ,12,2522,453476,0.20895179,37.57122131
80,事,そ,8,2502,455978,0.20729475,37.77851606
81,對,寸,14,2476,458454,0.20514061,37.98365667
82,沒,水,7,2411,460865,0.19975526,38.18341193
83,還,ひ,17,2384,463249,0.19751826,38.38093019
84,同,口,6,2330,465579,0.19304428,38.57397447
85,高,高,10,2292,467871,0.18989591,38.76387038
86,道,ひ,13,2287,470158,0.18948166,38.95335204
87,師,巾,10,2277,472435,0.18865314,39.14200518
88,氣,气,10,2276,474711,0.18857029,39.33057547
89,種,禾,14,2268,476979,0.18790747,39.51848294
90,而,而,6,2264,479243,0.18757607,39.70605901
91,回,囗,6,2262,481505,0.18741036,39.89346937
92,二,二,2,2261,483766,0.18732751,40.08079688
93,開,門,12,2248,486014,0.18625044,40.26704732
94,於,方,8,2238,488252,0.18542193,40.45246925
95,頭,頁,16,2234,490486,0.18509052,40.63755977
96,現,玉,11,2201,492687,0.18235642,40.81991619
97,做,人,11,2183,494870,0.18086509,41.00078128
98,文,文,4,2177,497047,0.18036798,41.18114926
99,媽,女,13,2115,499162,0.17523118,41.35638044
100,體,骨,23,2099,501261,0.17390555,41.53028599
101,些,二,8,2090,503351,0.17315989,41.70344588
102,最,た,12,2062,505413,0.17084004,41.87428592
103,寫,で,15,2061,507474,0.17075719,42.04504311
104,又,又,2,2043,509517,0.16926586,42.21430897
105,因,囗,6,2023,511540,0.16760883,42.38191780
106,前,刀,9,2016,513556,0.16702887,42.54894667
107,從,彳,11,1999,515555,0.16562039,42.71456706
108,法,水,8,1998,517553,0.16553754,42.88010460
109,明,日,8,1965,519518,0.16280343,43.04290803
110,行,行,6,1952,521470,0.16172636,43.20463439
111,問,口,11,1920,523390,0.15907511,43.36370950
112,意,心,13,1910,525300,0.15824659,43.52195609
113,花,艸,8,1901,527201,0.15750093,43.67945702
114,日,日,4,1889,529090,0.15650671,43.83596373
115,形,ね,7,1888,530978,0.15642386,43.99238759
116,知,矢,8,1877,532855,0.15551249,44.14790008
117,四,囗,5,1847,534702,0.15302694,44.30092702
118,快,心,7,1844,536546,0.15277839,44.45370541
119,之,ぜ,4,1832,538378,0.15178417,44.60548958
120,常,巾,11,1829,540207,0.15153561,44.75702519
121,經,糸,13,1819,542026,0.15070710,44.90773229
122,教,の,11,1793,543819,0.14855296,45.05628525
123,活,水,9,1783,545602,0.14772444,45.20400969
124,太,大,4,1779,547381,0.14739303,45.35140272
125,兩,入,8,1770,549151,0.14664737,45.49805009
126,果,木,8,1755,550906,0.14540459,45.64345468
127,本,木,5,1749,552655,0.14490748,45.78836216
128,兒,儿,8,1749,554404,0.14490748,45.93326964
129,點,黑,17,1745,556149,0.14457608,46.07784572
130,當,田,13,1739,557888,0.14407897,46.22192469
131,美,羊,9,1730,559618,0.14333330,46.36525799
132,校,木,10,1697,561315,0.14059920,46.50585719
133,進,ひ,12,1691,563006,0.14010209,46.64595928
134,等,竹,12,1684,564690,0.13952213,46.78548141
135,但,人,7,1682,566372,0.13935643,46.92483784
136,樂,木,15,1681,568053,0.13927357,47.06411141
137,部,邑,11,1663,569716,0.13778224,47.20189365
138,再,た,6,1651,571367,0.13678802,47.33868167
139,數,の,15,1649,573016,0.13662232,47.47530399
140,像,人,14,1636,574652,0.13554525,47.61084924
141,只,口,5,1629,576281,0.13496529,47.74581453
142,力,力,2,1626,577907,0.13471673,47.88053126
143,色,色,6,1625,579532,0.13463388,48.01516514
144,外,夕,5,1624,581156,0.13455103,48.14971617
145,真,目,10,1621,582777,0.13430248,48.28401865
146,各,口,6,1619,584396,0.13413677,48.41815542
147,山,山,3,1617,586013,0.13397107,48.55212649
148,題,頁,18,1610,587623,0.13339111,48.68551760
149,表,衣,8,1597,589220,0.13231404,48.81783164
150,請,言,15,1592,590812,0.13189978,48.94973142
151,課,言,15,1582,592394,0.13107126,49.08080268
152,月,月,4,1581,593975,0.13098841,49.21179109
153,呢,口,8,1576,595551,0.13057415,49.34236524
154,第,竹,11,1576,597127,0.13057415,49.47293939
155,位,人,7,1569,598696,0.12999419,49.60293358
156,定,で,8,1565,600261,0.12966279,49.73259637
157,比,比,4,1562,601823,0.12941423,49.86201060
158,與,臼,14,1558,603381,0.12908282,49.99109342
159,字,子,6,1553,604934,0.12866857,50.11976199
160,身,身,7,1544,606478,0.12792290,50.24768489
161,相,目,9,1535,608013,0.12717724,50.37486213
162,間,門,12,1528,609541,0.12659728,50.50145941
163,手,手,4,1520,611061,0.12593446,50.62739387
164,王,玉,4,1516,612577,0.12560306,50.75299693
165,主,せ,5,1508,614085,0.12494024,50.87793717
166,西,襾,6,1496,615581,0.12394602,51.00188319
167,電,雨,13,1486,617067,0.12311751,51.12500070
168,五,二,4,1468,618535,0.12162618,51.24662688
169,話,言,13,1466,620001,0.12146048,51.36808736
170,見,見,7,1464,621465,0.12129477,51.48938213
171,才,手,3,1460,622925,0.12096337,51.61034550
172,使,人,8,1460,624385,0.12096337,51.73130887
173,名,口,6,1457,625842,0.12071481,51.85202368
174,走,走,7,1453,627295,0.12038340,51.97240708
175,打,手,5,1441,628736,0.11938918,52.09179626
176,聲,耳,17,1438,630174,0.11914063,52.21093689
177,邊,ひ,19,1429,631603,0.11839497,52.32933186
178,將,寸,11,1427,633030,0.11822926,52.44756112
179,海,水,10,1419,634449,0.11756645,52.56512757
180,給,糸,12,1419,635868,0.11756645,52.68269402
181,白,白,5,1407,637275,0.11657223,52.79926625
182,正,止,5,1404,638679,0.11632367,52.91558992
183,幾,ど,12,1395,640074,0.11557801,53.03116793
184,愛,心,13,1384,641458,0.11466664,53.14583457
185,音,音,9,1377,642835,0.11408668,53.25992125
186,並,一,8,1374,644209,0.11383813,53.37375938
187,加,力,5,1372,645581,0.11367242,53.48743180
188,怎,心,9,1372,646953,0.11367242,53.60110422
189,少,小,4,1371,648324,0.11358957,53.71469379
190,新,斤,13,1370,649694,0.11350672,53.82820051
191,吃,口,6,1368,651062,0.11334102,53.94154153
192,習,羽,11,1368,652430,0.11334102,54.05488255
193,她,女,6,1366,653796,0.11317531,54.16805786
194,變,言,23,1357,655153,0.11242965,54.28048751
195,被,衣,11,1355,656508,0.11226395,54.39275146
196,光,儿,6,1353,657861,0.11209824,54.50484970
197,情,心,11,1350,659211,0.11184969,54.61669939
198,重,里,9,1348,660559,0.11168398,54.72838337
199,或,戈,8,1343,661902,0.11126973,54.83965310
200,由,田,5,1338,663240,0.11085547,54.95050857
201,記,言,10,1336,664576,0.11068976,55.06119833
202,謝,言,17,1330,665906,0.11019265,55.17139098
203,爸,父,8,1326,667232,0.10986125,55.28125223
204,民,氏,5,1320,668552,0.10936414,55.39061637
205,親,見,16,1320,669872,0.10936414,55.49998051
206,聽,耳,22,1320,671192,0.10936414,55.60934465
207,全,入,6,1318,672510,0.10919844,55.71854309
208,化,匕,4,1308,673818,0.10836992,55.82691301
209,空,穴,8,1308,675126,0.10836992,55.93528293
210,向,口,6,1296,676422,0.10737570,56.04265863
211,其,八,8,1288,677710,0.10671289,56.14937152
212,嗎,口,13,1287,678997,0.10663004,56.25600156
213,實,で,14,1287,680284,0.10663004,56.36263160
214,每,毋,7,1281,681565,0.10613293,56.46876453
215,風,風,9,1261,682826,0.10447589,56.57324042
216,望,月,11,1260,684086,0.10439304,56.67763346
217,別,刀,7,1253,685339,0.10381308,56.78144654
218,原,厂,10,1241,686580,0.10281886,56.88426540
219,畫,田,12,1236,687816,0.10240460,56.98667000
220,星,日,9,1232,689048,0.10207320,57.08874320
221,候,人,10,1221,690269,0.10116183,57.18990503
222,次,欠,6,1216,691485,0.10074757,57.29065260
223,口,口,3,1213,692698,0.10049902,57.39115162
224,先,儿,6,1211,693909,0.10033331,57.49148493
225,答,竹,12,1204,695113,0.09975335,57.59123828
226,度,な,9,1202,696315,0.09958765,57.69082593
227,哪,口,10,1201,697516,0.09950480,57.79033073
228,東,木,8,1200,698716,0.09942194,57.88975267
229,平,干,5,1197,699913,0.09917339,57.98892606
230,它,で,5,1194,701107,0.09892483,58.08785089
231,無,火,12,1191,702298,0.09867628,58.18652717
232,工,工,3,1189,703487,0.09851058,58.28503775
233,石,石,5,1188,704675,0.09842772,58.38346547
234,合,口,6,1181,705856,0.09784776,58.48131323
235,此,止,6,1179,707035,0.09768206,58.57899529
236,及,又,4,1176,708211,0.09743351,58.67642880
237,元,儿,4,1167,709378,0.09668784,58.77311664
238,已,己,3,1164,710542,0.09643929,58.86955593
239,母,毋,5,1159,711701,0.09602503,58.96558096
240,特,牛,10,1155,712856,0.09569362,59.06127458
241,六,八,4,1150,714006,0.09527936,59.15655394
242,己,己,3,1142,715148,0.09461655,59.25117049
243,女,女,3,1141,716289,0.09453370,59.34570419
244,球,玉,11,1141,717430,0.09453370,59.44023789
245,馬,馬,10,1127,718557,0.09337378,59.53361167
246,讓,言,24,1126,719683,0.09329092,59.62690259
247,安,で,6,1121,720804,0.09287667,59.71977926
248,帶,巾,11,1119,721923,0.09271096,59.81249022
249,感,心,13,1116,723039,0.09246241,59.90495263
250,圖,囗,14,1110,724149,0.09196530,59.99691793
251,龍,龍,16,1103,725252,0.09138534,60.08830327
252,書,曰,10,1099,726351,0.09105393,60.17935720
253,叫,口,5,1098,727449,0.09097108,60.27032828
254,樹,木,16,1097,728546,0.09088823,60.36121651
255,友,又,4,1095,729641,0.09072252,60.45193903
256,類,頁,19,1083,730724,0.08972830,60.54166733
257,理,玉,11,1078,731802,0.08931405,60.63098138
258,您,心,11,1074,732876,0.08898264,60.71996402
259,路,足,13,1056,733932,0.08749131,60.80745533
260,放,の,8,1055,734987,0.08740846,60.89486379
261,覺,見,20,1041,736028,0.08624854,60.98111233
262,代,人,5,1040,737068,0.08616569,61.06727802
263,內,入,4,1037,738105,0.08591713,61.15319515
264,應,心,17,1027,739132,0.08508861,61.23828376
265,張,弓,11,1026,740158,0.08500576,61.32328952
266,住,人,7,1025,741183,0.08492291,61.40821243
267,量,里,12,1022,742205,0.08467436,61.49288679
268,立,立,5,1015,743220,0.08409439,61.57698118
269,更,曰,7,1011,744231,0.08376299,61.66074417
270,許,言,11,1011,745242,0.08376299,61.74450716
271,喜,口,12,1009,746251,0.08359728,61.82810444
272,關,門,19,1008,747259,0.08351443,61.91161887
273,機,木,16,995,748254,0.08243736,61.99405623
274,歡,欠,22,984,749238,0.08152599,62.07558222
275,便,人,9,969,750207,0.08028322,62.15586544
276,完,で,7,966,751173,0.08003467,62.23590011
277,世,一,5,957,752130,0.07928900,62.31518911
278,解,角,13,957,753087,0.07928900,62.39447811
279,造,ひ,11,955,754042,0.07912330,62.47360141
280,利,刀,7,953,754995,0.07895759,62.55255900
281,流,水,9,942,755937,0.07804623,62.63060523
282,處,虍,11,942,756879,0.07804623,62.70865146
283,算,竹,14,941,757820,0.07796337,62.78661483
284,期,月,12,939,758759,0.07779767,62.86441250
285,臺,至,14,937,759696,0.07763197,62.94204447
286,弟,弓,7,935,760631,0.07746626,63.01951073
287,車,車,7,929,761560,0.07696916,63.09647989
288,入,入,2,926,762486,0.07672060,63.17320049
289,北,匕,5,925,763411,0.07663775,63.24983824
290,業,木,13,924,764335,0.07655490,63.32639314
291,眼,目,11,922,765257,0.07638919,63.40278233
292,例,人,8,921,766178,0.07630634,63.47908867
293,找,手,7,921,767099,0.07630634,63.55539501
294,百,白,6,917,768016,0.07597494,63.63136995
295,直,目,8,908,768924,0.07522927,63.70659922
296,照,火,13,907,769831,0.07514642,63.78174564
297,朋,月,8,904,770735,0.07489786,63.85664350
298,式,弋,6,900,771635,0.07456646,63.93120996
299,節,竹,13,899,772534,0.07448361,64.00569357
300,接,手,11,893,773427,0.07398650,64.07968007
301,目,目,5,892,774319,0.07390365,64.15358372
302,讀,言,22,891,775210,0.07382079,64.22740451
303,指,手,9,885,776095,0.07332368,64.30072819
304,神,示,10,880,776975,0.07290943,64.37363762
305,飛,飛,9,868,777843,0.07191521,64.44555283
306,非,非,8,867,778710,0.07183235,64.51738518
307,希,巾,7,866,779576,0.07174950,64.58913468
308,七,一,2,858,780434,0.07108669,64.66022137
309,條,木,11,858,781292,0.07108669,64.73130806
310,吧,口,7,856,782148,0.07092099,64.80222905
311,陽,阜,12,852,783000,0.07058958,64.87281863
312,食,食,9,851,783851,0.07050673,64.94332536
313,南,十,9,844,784695,0.06992677,65.01325213
314,八,八,2,843,785538,0.06984392,65.08309605
315,結,糸,12,839,786377,0.06951251,65.15260856
316,門,門,8,836,787213,0.06926395,65.22187251
317,展,尸,10,836,788049,0.06926395,65.29113646
318,連,ひ,11,834,788883,0.06909825,65.36023471
319,今,人,4,826,789709,0.06843544,65.42867015
320,河,水,8,826,790535,0.06843544,65.49710559
321,通,ひ,11,825,791360,0.06835259,65.56545818
322,容,で,10,824,792184,0.06826974,65.63372792
323,觀,見,25,824,793008,0.06826974,65.70199766
324,玩,玉,8,823,793831,0.06818688,65.77018454
325,興,臼,16,821,794652,0.06802118,65.83820572
326,句,口,5,816,795468,0.06760692,65.90581264
327,傳,人,13,813,796281,0.06735837,65.97317101
328,認,言,14,813,797094,0.06735837,66.04052938
329,隻,隹,10,804,797898,0.06661270,66.10714208
330,詞,言,12,803,798701,0.06652985,66.17367193
331,性,心,8,801,799502,0.06636415,66.24003608
332,卻,つ,9,801,800303,0.06636415,66.30640023
333,木,木,4,800,801103,0.06628130,66.37268153
334,近,ひ,8,794,801897,0.06578419,66.43846572
335,萬,禸,13,793,802690,0.06570133,66.50416705
336,金,金,8,792,803482,0.06561848,66.56978553
337,選,ひ,16,791,804273,0.06553563,66.63532116
338,清,水,11,788,805061,0.06528708,66.70060824
339,火,火,4,786,805847,0.06512137,66.76572961
340,信,人,9,785,806632,0.06503852,66.83076813
341,填,土,13,784,807416,0.06495567,66.89572380
342,孩,子,9,772,808188,0.06396145,66.95968525
343,者,老,8,766,808954,0.06346434,67.02314959
344,父,父,4,764,809718,0.06329864,67.08644823
345,魚,魚,11,764,810482,0.06329864,67.14974687
346,受,又,8,758,811240,0.06280153,67.21254840
347,號,虍,13,756,811996,0.06263582,67.27518422
348,亮,ぞ,9,754,812750,0.06247012,67.33765434
349,收,の,6,749,813499,0.06205586,67.39971020
350,林,木,8,749,814248,0.06205586,67.46176606
351,熱,火,15,749,814997,0.06205586,67.52382192
352,品,口,9,747,815744,0.06189016,67.58571208
353,班,玉,10,744,816488,0.06164161,67.64735369
354,斯,斤,12,739,817227,0.06122735,67.70858104
355,牠,牛,7,738,817965,0.06114450,67.76972554
356,稱,禾,14,738,818703,0.06114450,67.83087004
357,肉,肉,6,736,819439,0.06097879,67.89184883
358,腦,肉,13,731,820170,0.06056453,67.95241336
359,難,隹,19,729,820899,0.06039883,68.01281219
360,念,心,8,727,821626,0.06023313,68.07304532
361,線,糸,15,727,822353,0.06023313,68.13327845
362,思,心,9,726,823079,0.06015028,68.19342873
363,片,片,4,723,823802,0.05990172,68.25333045
364,語,言,14,722,824524,0.05981887,68.31314932
365,故,の,9,721,825245,0.05973602,68.37288534
366,市,巾,5,715,825960,0.05923891,68.43212425
367,角,角,7,714,826674,0.05915606,68.49128031
368,網,糸,14,712,827386,0.05899035,68.55027066
369,場,土,12,710,828096,0.05882465,68.60909531
370,提,手,12,707,828803,0.05857610,68.66767141
371,草,艸,10,705,829508,0.05841039,68.72608180
372,啊,口,11,705,830213,0.05841039,68.78449219
373,遠,ひ,14,703,830916,0.05824469,68.84273688
374,九,乙,2,701,831617,0.05807899,68.90081587
375,跟,足,13,701,832318,0.05807899,68.95889486
376,麗,鹿,19,698,833016,0.05783043,69.01672529
377,區,っ,11,694,833710,0.05749902,69.07422431
378,笑,竹,10,694,834404,0.05749902,69.13172333
379,術,行,11,694,835098,0.05749902,69.18922235
380,影,ね,15,693,835791,0.05741617,69.24663852
381,滿,水,14,692,836483,0.05733332,69.30397184
382,達,ひ,13,692,837175,0.05733332,69.36130516
383,且,一,5,691,837866,0.05725047,69.41855563
384,建,に,9,690,838556,0.05716762,69.47572325
385,辦,辛,16,688,839244,0.05700191,69.53272516
386,早,日,6,685,839929,0.05675336,69.58947852
387,園,囗,13,683,840612,0.05658766,69.64606618
388,管,竹,14,682,841294,0.05650480,69.70257098
389,往,彳,8,675,841969,0.05592484,69.75849582
390,注,水,8,675,842644,0.05592484,69.81442066
391,除,阜,10,670,843314,0.05551059,69.86993125
392,黃,黃,12,670,843984,0.05551059,69.92544184
393,死,歹,6,668,844652,0.05534488,69.98078672
394,示,示,5,668,845320,0.05534488,70.03613160
395,段,殳,9,668,845988,0.05534488,70.09147648
396,科,禾,9,668,846656,0.05534488,70.14682136
397,保,人,9,666,847322,0.05517918,70.20200054
398,器,口,16,665,847987,0.05509633,70.25709687
399,服,月,8,664,848651,0.05501348,70.31211035
400,紅,糸,9,664,849315,0.05501348,70.36712383
401,留,田,10,663,849978,0.05493062,70.42205445
402,曲,曰,6,662,850640,0.05484777,70.47690222
403,何,人,7,659,851299,0.05459922,70.53150144
404,味,口,8,659,851958,0.05459922,70.58610066
405,單,口,12,656,852614,0.05435066,70.64045132
406,界,田,9,655,853269,0.05426781,70.69471913
407,站,立,10,653,853922,0.05410211,70.74882124
408,命,口,8,650,854572,0.05385355,70.80267479
409,包,ぢ,5,647,855219,0.05360500,70.85627979
410,告,口,7,644,855863,0.05335644,70.90963623
411,產,生,11,644,856507,0.05335644,70.96299267
412,導,寸,16,643,857150,0.05327359,71.01626626
413,交,ぞ,6,640,857790,0.05302504,71.06929130
414,練,糸,15,639,858429,0.05294219,71.12223349
415,拿,手,10,633,859062,0.05244508,71.17467857
416,土,土,3,631,859693,0.05227937,71.22695794
417,該,言,13,628,860321,0.05203082,71.27898876
418,拉,手,8,627,860948,0.05194797,71.33093673
419,運,ひ,13,626,861574,0.05186511,71.38280184
420,義,羊,13,623,862197,0.05161656,71.43441840
421,古,口,5,622,862819,0.05153371,71.48595211
422,共,八,6,621,863440,0.05145086,71.53740297
423,歌,欠,14,621,864061,0.05145086,71.58885383
424,育,肉,7,619,864680,0.05128515,71.64013898
425,奇,大,8,616,865296,0.05103660,71.69117558
426,計,言,9,616,865912,0.05103660,71.74221218
427,灣,水,25,616,866528,0.05103660,71.79324878
428,布,巾,5,615,867143,0.05095375,71.84420253
429,祝,示,10,612,867755,0.05070519,71.89490772
430,列,刀,6,611,868366,0.05062234,71.94553006
431,鳥,鳥,11,611,868977,0.05062234,71.99615240
432,功,力,5,610,869587,0.05053949,72.04669189
433,求,水,7,610,870197,0.05053949,72.09723138
434,城,土,9,610,870807,0.05053949,72.14777087
435,寶,で,20,606,871413,0.05020808,72.19797895
436,報,土,12,604,872017,0.05004238,72.24802133
437,約,糸,9,602,872619,0.04987668,72.29789801
438,改,の,7,601,873220,0.04979382,72.34769183
439,深,水,11,599,873819,0.04962812,72.39731995
440,較,車,13,599,874418,0.04962812,72.44694807
441,爾,爻,14,599,875017,0.04962812,72.49657619
442,象,豕,12,593,875610,0.04913101,72.54570720
443,福,示,14,593,876203,0.04913101,72.59483821
444,幫,巾,17,593,876796,0.04913101,72.64396922
445,格,木,10,592,877388,0.04904816,72.69301738
446,葉,艸,13,592,877980,0.04904816,72.74206554
447,細,糸,11,591,878571,0.04896531,72.79103085
448,設,言,11,581,879152,0.04813679,72.83916764
449,任,人,6,579,879731,0.04797109,72.88713873
450,始,女,8,579,880310,0.04797109,72.93510982
451,晚,日,11,579,880889,0.04797109,72.98308091
452,哈,口,9,578,881467,0.04788824,73.03096915
453,苦,艸,9,578,882045,0.04788824,73.07885739
454,春,日,9,576,882621,0.04772253,73.12657992
455,識,言,19,576,883197,0.04772253,73.17430245
456,久,ぜ,3,575,883772,0.04763968,73.22194213
457,步,止,7,575,884347,0.04763968,73.26958181
458,千,十,3,574,884921,0.04755683,73.31713864
459,強,弓,11,574,885495,0.04755683,73.36469547
460,溫,水,13,574,886069,0.04755683,73.41225230
461,跑,足,12,573,886642,0.04747398,73.45972628
462,落,艸,13,573,887215,0.04747398,73.50720026
463,至,至,6,572,887787,0.04739113,73.55459139
464,輕,車,14,571,888358,0.04730828,73.60189967
465,積,禾,16,570,888928,0.04722542,73.64912509
466,則,刀,9,566,889494,0.04689402,73.69601911
467,雨,雨,8,564,890058,0.04672831,73.74274742
468,參,づ,11,564,890622,0.04672831,73.78947573
469,根,木,10,564,891186,0.04672831,73.83620404
470,整,の,16,562,891748,0.04656261,73.88276665
471,巴,己,4,561,892309,0.04647976,73.92924641
472,統,糸,11,560,892869,0.04639691,73.97564332
473,轉,車,18,560,893429,0.04639691,74.02204023
474,里,里,7,557,893986,0.04614835,74.06818858
475,總,糸,17,557,894543,0.04614835,74.11433693
476,首,首,9,556,895099,0.04606550,74.16040243
477,錢,金,16,556,895655,0.04606550,74.20646793
478,具,八,8,554,896209,0.04589980,74.25236773
479,哥,口,10,552,896761,0.04573409,74.29810182
480,精,米,14,552,897313,0.04573409,74.34383591
481,試,言,13,552,897865,0.04573409,74.38957000
482,雖,隹,17,551,898416,0.04565124,74.43522124
483,考,老,6,550,898966,0.04556839,74.48078963
484,離,隹,19,549,899515,0.04548554,74.52627517
485,士,士,3,547,900062,0.04531984,74.57159501
486,言,言,7,544,900606,0.04507128,74.61666629
487,底,な,8,542,901148,0.04490558,74.66157187
488,華,艸,12,540,901688,0.04473987,74.70631174
489,夫,大,4,533,902221,0.04415991,74.75047165
490,阿,阜,8,533,902754,0.04415991,74.79463156
491,藝,艸,19,533,903287,0.04415991,74.83879147
492,演,水,14,531,903818,0.04399421,74.88278568
493,呀,口,7,530,904348,0.04391136,74.92669704
494,件,人,6,529,904877,0.04382851,74.97052555
495,青,青,8,525,905402,0.04349710,75.01402265
496,送,ひ,10,524,905926,0.04341425,75.05743690
497,組,糸,11,523,906449,0.04333140,75.10076830
498,皮,皮,5,521,906970,0.04316569,75.14393399
499,半,十,5,518,907488,0.04291714,75.18685113
500,夜,夕,8,516,908004,0.04275144,75.22960257
501,級,糸,10,516,908520,0.04275144,75.27235401
502,遊,ひ,13,516,909036,0.04275144,75.31510545
503,舉,臼,17,516,909552,0.04275144,75.35785689
504,反,又,4,515,910067,0.04266858,75.40052547
505,腳,肉,13,513,910580,0.04250288,75.44302835
506,刻,刀,8,509,911089,0.04217147,75.48519982
507,筆,竹,12,509,911598,0.04217147,75.52737129
508,童,立,12,507,912105,0.04200577,75.56937706
509,怕,心,8,505,912610,0.04184007,75.61121713
510,骨,骨,10,504,913114,0.04175722,75.65297435
511,縣,糸,16,504,913618,0.04175722,75.69473157
512,程,禾,12,499,914117,0.04134296,75.73607453
513,忙,心,6,497,914614,0.04117726,75.77725179
514,室,で,9,494,915108,0.04092870,75.81818049
515,蟲,虫,18,493,915601,0.04084585,75.85902634
516,克,儿,7,492,916093,0.04076300,75.89978934
517,跳,足,13,492,916585,0.04076300,75.94055234
518,台,口,5,490,917075,0.04059729,75.98114963
519,鄉,邑,12,490,917565,0.04059729,76.02174692
520,論,言,15,490,918055,0.04059729,76.06234421
521,娘,女,10,489,918544,0.04051444,76.10285865
522,族,方,11,487,919031,0.04034874,76.14320739
523,誰,言,15,486,919517,0.04026589,76.18347328
524,假,人,11,485,920002,0.04018304,76.22365632
525,怪,心,8,483,920485,0.04001733,76.26367365
526,植,木,12,483,920968,0.04001733,76.30369098
527,環,玉,17,483,921451,0.04001733,76.34370831
528,料,斗,10,482,921933,0.03993448,76.38364279
529,黑,黑,12,482,922415,0.03993448,76.42357727
530,響,音,21,480,922895,0.03976878,76.46334605
531,裝,衣,13,479,923374,0.03968593,76.50303198
532,牛,牛,4,478,923852,0.03960307,76.54263505
533,英,艸,9,478,924330,0.03960307,76.58223812
534,禮,示,18,474,924804,0.03927167,76.62150979
535,紀,糸,9,473,925277,0.03918882,76.66069861
536,唱,口,11,472,925749,0.03910596,76.69980457
537,資,貝,13,470,926219,0.03894026,76.73874483
538,倒,人,10,469,926688,0.03885741,76.77760224
539,排,手,11,469,927157,0.03885741,76.81645965
540,越,走,12,469,927626,0.03885741,76.85531706
541,朝,月,12,469,928095,0.03885741,76.89417447
542,備,人,12,466,928561,0.03860886,76.93278333
543,船,舟,11,464,929025,0.03844315,76.97122648
544,坐,土,7,463,929488,0.03836030,77.00958678
545,病,ば,10,461,929949,0.03819460,77.04778138
546,鐵,金,21,460,930409,0.03811175,77.08589313
547,視,見,12,459,930868,0.03802889,77.12392202
548,史,口,5,456,931324,0.03778034,77.16170236
549,妹,女,8,456,931780,0.03778034,77.19948270
550,板,木,8,456,932236,0.03778034,77.23726304
551,紙,糸,10,456,932692,0.03778034,77.27504338
552,詩,言,13,456,933148,0.03778034,77.31282372
553,狀,犬,8,453,933601,0.03753178,77.35035550
554,農,辰,13,452,934053,0.03744893,77.38780443
555,趕,走,14,450,934503,0.03728323,77.42508766
556,啦,口,11,449,934952,0.03720038,77.46228804
557,錯,金,16,449,935401,0.03720038,77.49948842
558,房,戶,8,448,935849,0.03711753,77.53660595
559,夠,夕,11,447,936296,0.03703467,77.57364062
560,戲,戈,17,446,936742,0.03695182,77.61059244
561,養,食,15,445,937187,0.03686897,77.64746141
562,亞,二,8,444,937631,0.03678612,77.68424753
563,員,口,10,444,938075,0.03678612,77.72103365
564,李,木,7,442,938517,0.03662042,77.75765407
565,畢,田,11,440,938957,0.03645471,77.79410878
566,斷,斤,18,438,939395,0.03628901,77.83039779
567,型,土,9,435,939830,0.03604045,77.86643824
568,雄,隹,12,435,940265,0.03604045,77.90247869
569,衣,衣,6,434,940699,0.03595760,77.93843629
570,消,水,10,434,941133,0.03595760,77.97439389
571,奶,女,5,432,941565,0.03579190,78.01018579
572,左,工,5,431,941996,0.03570905,78.04589484
573,恐,心,10,431,942427,0.03570905,78.08160389
574,塊,土,13,429,942856,0.03554335,78.11714724
575,座,な,10,428,943284,0.03546049,78.15260773
576,尺,尸,4,427,943711,0.03537764,78.18798537
577,終,糸,11,427,944138,0.03537764,78.22336301
578,燈,火,16,427,944565,0.03537764,78.25874065
579,緊,糸,14,425,944990,0.03521194,78.29395259
580,團,囗,14,424,945414,0.03512909,78.32908168
581,層,尸,15,424,945838,0.03512909,78.36421077
582,油,水,8,422,946260,0.03496338,78.39917415
583,院,阜,10,422,946682,0.03496338,78.43413753
584,察,で,14,420,947102,0.03479768,78.46893521
585,助,力,7,419,947521,0.03471483,78.50365004
586,準,水,13,419,947940,0.03471483,78.53836487
587,決,水,7,418,948358,0.03463198,78.57299685
588,伯,人,7,418,948776,0.03463198,78.60762883
589,周,口,8,417,949193,0.03454913,78.64217796
590,失,大,5,416,949609,0.03446627,78.67664423
591,易,日,8,414,950023,0.03430057,78.71094480
592,依,人,8,414,950437,0.03430057,78.74524537
593,妳,女,8,413,950850,0.03421772,78.77946309
594,吸,口,7,413,951263,0.03421772,78.81368081
595,政,の,9,411,951674,0.03405202,78.84773283
596,停,人,11,410,952084,0.03396916,78.88170199
597,訴,言,12,410,952494,0.03396916,78.91567115
598,羅,网,19,410,952904,0.03396916,78.94964031
599,必,心,5,409,953313,0.03388631,78.98352662
600,婆,女,11,409,953722,0.03388631,79.01741293
601,綠,糸,14,409,954131,0.03388631,79.05129924
602,右,口,5,408,954539,0.03380346,79.08510270
603,令,人,5,408,954947,0.03380346,79.11890616
604,景,日,12,406,955353,0.03363776,79.15254392
605,雲,雨,12,406,955759,0.03363776,79.18618168
606,買,貝,12,406,956165,0.03363776,79.21981944
607,軍,車,9,404,956569,0.03347205,79.25329149
608,似,人,7,402,956971,0.03330635,79.28659784
609,護,言,21,402,957373,0.03330635,79.31990419
610,引,弓,4,399,957772,0.03305780,79.35296199
611,驗,馬,23,399,958171,0.03305780,79.38601979
612,甲,田,5,395,958566,0.03272639,79.41874618
613,掉,手,11,395,958961,0.03272639,79.45147257
614,剛,刀,10,394,959355,0.03264354,79.48411611
615,圓,囗,13,393,959748,0.03256069,79.51667680
616,取,又,8,392,960140,0.03247784,79.54915464
617,查,木,9,392,960532,0.03247784,79.58163248
618,基,土,11,391,960923,0.03239498,79.61402746
619,調,言,15,391,961314,0.03239498,79.64642244
620,隨,阜,16,390,961704,0.03231213,79.67873457
621,害,で,10,389,962093,0.03222928,79.71096385
622,境,土,14,389,962482,0.03222928,79.74319313
623,野,里,11,388,962870,0.03214643,79.77533956
624,康,な,11,388,963258,0.03214643,79.80748599
625,息,心,10,387,963645,0.03206358,79.83954957
626,竹,竹,6,386,964031,0.03198073,79.87153030
627,群,羊,13,386,964417,0.03198073,79.90351103
628,戰,戈,16,385,964802,0.03189787,79.93540890
629,置,网,13,384,965186,0.03181502,79.96722392
630,狗,犬,8,383,965569,0.03173217,79.99895609
631,極,木,13,383,965952,0.03173217,80.03068826
632,推,手,11,382,966334,0.03164932,80.06233758
633,漸,水,14,382,966716,0.03164932,80.09398690
634,居,尸,8,381,967097,0.03156647,80.12555337
635,德,彳,15,381,967478,0.03156647,80.15711984
636,絲,糸,12,380,967858,0.03148362,80.18860346
637,足,足,7,379,968237,0.03140076,80.22000422
638,冷,ち,7,379,968616,0.03140076,80.25140498
639,館,食,16,378,968994,0.03131791,80.28272289
640,即,つ,7,377,969371,0.03123506,80.31395795
641,傷,人,13,376,969747,0.03115221,80.34511016
642,製,衣,14,375,970122,0.03106936,80.37617952
643,臉,肉,17,375,970497,0.03106936,80.40724888
644,集,隹,12,374,970871,0.03098651,80.43823539
645,社,示,8,373,971244,0.03090365,80.46913904
646,卡,卜,5,372,971616,0.03082080,80.49995984
647,歲,止,13,371,971987,0.03073795,80.53069779
648,舞,舛,14,371,972358,0.03073795,80.56143574
649,賽,貝,17,371,972729,0.03073795,80.59217369
650,香,香,9,370,973099,0.03065510,80.62282879
651,琴,玉,12,370,973469,0.03065510,80.65348389
652,慢,心,14,369,973838,0.03057225,80.68405614
653,牙,牙,4,368,974206,0.03048940,80.71454554
654,曾,曰,12,368,974574,0.03048940,80.74503494
655,沙,水,7,367,974941,0.03040654,80.77544148
656,穿,穴,9,365,975306,0.03024084,80.80568232
657,睡,目,14,364,975670,0.03015799,80.83584031
658,需,雨,14,364,976034,0.03015799,80.86599830
659,般,舟,10,363,976397,0.03007514,80.89607344
660,蘭,艸,21,362,976759,0.02999229,80.92606573
661,歷,止,16,360,977119,0.02982658,80.95589231
662,質,貝,15,359,977478,0.02974373,80.98563604
663,切,刀,4,358,977836,0.02966088,81.01529692
664,爺,父,13,358,978194,0.02966088,81.04495780
665,洲,水,9,356,978550,0.02949518,81.07445298
666,孔,子,4,355,978905,0.02941233,81.10386531
667,突,穴,9,355,979260,0.02941233,81.13327764
668,源,水,13,354,979614,0.02932947,81.16260711
669,震,雨,15,353,979967,0.02924662,81.19185373
670,靜,青,16,353,980320,0.02924662,81.22110035
671,充,儿,5,352,980672,0.02916377,81.25026412
672,錄,金,16,352,981024,0.02916377,81.27942789
673,午,十,4,351,981375,0.02908092,81.30850881
674,講,言,17,351,981726,0.02908092,81.33758973
675,系,糸,7,350,982076,0.02899807,81.36658780
676,急,心,9,350,982426,0.02899807,81.39558587
677,藏,艸,18,350,982776,0.02899807,81.42458394
678,速,ひ,11,348,983124,0.02883236,81.45341630
679,升,十,4,346,983470,0.02866666,81.48208296
680,持,手,9,346,983816,0.02866666,81.51074962
681,討,言,10,346,984162,0.02866666,81.53941628
682,短,矢,12,346,984508,0.02866666,81.56808294
683,客,で,9,345,984853,0.02858381,81.59666675
684,迷,ひ,10,345,985198,0.02858381,81.62525056
685,順,頁,12,344,985542,0.02850096,81.65375152
686,米,米,6,343,985885,0.02841811,81.68216963
687,另,口,5,342,986227,0.02833525,81.71050488
688,低,人,7,342,986569,0.02833525,81.73884013
689,帝,巾,9,342,986911,0.02833525,81.76717538
690,呼,口,8,339,987250,0.02808670,81.79526208
691,富,で,12,339,987589,0.02808670,81.82334878
692,貴,貝,12,339,987928,0.02808670,81.85143548
693,續,糸,21,339,988267,0.02808670,81.87952218
694,存,子,6,337,988604,0.02792100,81.90744318
695,態,心,14,337,988941,0.02792100,81.93536418
696,驚,馬,23,337,989278,0.02792100,81.96328518
697,洋,水,9,335,989613,0.02775529,81.99104047
698,務,力,11,334,989947,0.02767244,82.01871291
699,健,人,11,333,990280,0.02758959,82.04630250
700,費,貝,12,333,990613,0.02758959,82.07389209
701,玉,玉,5,332,990945,0.02750674,82.10139883
702,背,肉,9,332,991277,0.02750674,82.12890557
703,維,糸,14,331,991608,0.02742389,82.15632946
704,姊,女,8,329,991937,0.02725818,82.18358764
705,盡,皿,14,329,992266,0.02725818,82.21084582
706,廣,な,15,329,992595,0.02725818,82.23810400
707,仙,人,5,328,992923,0.02717533,82.26527933
708,創,刀,12,327,993250,0.02709248,82.29237181
709,據,手,16,327,993577,0.02709248,82.31946429
710,究,穴,7,326,993903,0.02700963,82.34647392
711,彩,ね,11,326,994229,0.02700963,82.37348355
712,優,人,17,326,994555,0.02700963,82.40049318
713,辛,辛,7,325,994880,0.02692678,82.42741996
714,喔,口,12,322,995202,0.02667822,82.45409818
715,裏,衣,13,322,995524,0.02667822,82.48077640
716,供,人,8,320,995844,0.02651252,82.50728892
717,永,水,5,319,996163,0.02642967,82.53371859
718,田,田,5,319,996482,0.02642967,82.56014826
719,官,で,8,318,996800,0.02634682,82.58649508
720,待,彳,9,318,997118,0.02634682,82.61284190
721,男,田,7,317,997435,0.02626396,82.63910586
722,修,人,10,317,997752,0.02626396,82.66536982
723,雙,隹,18,317,998069,0.02626396,82.69163378
724,陳,阜,11,316,998385,0.02618111,82.71781489
725,測,水,12,315,998700,0.02609826,82.74391315
726,標,木,15,315,999015,0.02609826,82.77001141
727,鼓,鼓,13,314,999329,0.02601541,82.79602682
728,毛,毛,4,313,999642,0.02593256,82.82195938
729,案,木,10,313,999955,0.02593256,82.84789194
730,飯,食,12,313,1000268,0.02593256,82.87382450
731,針,金,10,311,1000579,0.02576685,82.89959135
732,旅,方,10,311,1000890,0.02576685,82.92535820
733,含,口,7,310,1001200,0.02568400,82.95104220
734,竟,音,11,310,1001510,0.02568400,82.97672620
735,領,頁,14,310,1001820,0.02568400,83.00241020
736,顆,頁,17,310,1002130,0.02568400,83.02809420
737,研,石,9,308,1002438,0.02551830,83.05361250
738,屬,尸,21,308,1002746,0.02551830,83.07913080
739,材,木,7,307,1003053,0.02543545,83.10456625
740,拜,手,9,307,1003360,0.02543545,83.13000170
741,適,ひ,15,307,1003667,0.02543545,83.15543715
742,善,羊,12,306,1003973,0.02535260,83.18078975
743,枝,木,8,304,1004277,0.02518689,83.20597664
744,增,土,15,304,1004581,0.02518689,83.23116353
745,頁,頁,9,303,1004884,0.02510404,83.25626757
746,眾,目,11,302,1005186,0.02502119,83.28128876
747,睛,目,13,302,1005488,0.02502119,83.30630995
748,岩,山,8,301,1005789,0.02493834,83.33124829
749,密,で,11,301,1006090,0.02493834,83.35618663
750,醫,酉,18,301,1006391,0.02493834,83.38112497
751,趣,走,15,299,1006690,0.02477263,83.40589760
752,姑,女,8,298,1006988,0.02468978,83.43058738
753,附,阜,8,298,1007286,0.02468978,83.45527716
754,劇,刀,15,298,1007584,0.02468978,83.47996694
755,盤,皿,15,298,1007882,0.02468978,83.50465672
756,治,水,8,297,1008179,0.02460693,83.52926365
757,乾,乙,11,297,1008476,0.02460693,83.55387058
758,項,頁,12,297,1008773,0.02460693,83.57847751
759,確,石,15,297,1009070,0.02460693,83.60308444
760,村,木,7,296,1009366,0.02452408,83.62760852
761,武,止,8,296,1009662,0.02452408,83.65213260
762,波,水,8,296,1009958,0.02452408,83.67665668
763,救,の,11,296,1010254,0.02452408,83.70118076
764,省,目,9,295,1010549,0.02444123,83.72562199
765,專,寸,11,295,1010844,0.02444123,83.75006322
766,顧,頁,21,295,1011139,0.02444123,83.77450445
767,印,つ,6,293,1011432,0.02427552,83.79877997
768,摩,手,15,293,1011725,0.02427552,83.82305549
769,寒,で,12,292,1012017,0.02419267,83.84724816
770,藍,艸,18,290,1012307,0.02402697,83.87127513
771,雞,隹,18,290,1012597,0.02402697,83.89530210
772,屋,尸,9,289,1012886,0.02394412,83.91924622
773,嘴,口,16,289,1013175,0.02394412,83.94319034
774,未,木,5,288,1013463,0.02386127,83.96705161
775,模,木,15,288,1013751,0.02386127,83.99091288
776,技,手,7,287,1014038,0.02377841,84.01469129
777,鼠,鼠,13,287,1014325,0.02377841,84.03846970
778,血,血,6,286,1014611,0.02369556,84.06216526
779,休,人,6,284,1014895,0.02352986,84.08569512
780,射,寸,10,284,1015179,0.02352986,84.10922498
781,喝,口,12,283,1015462,0.02344701,84.13267199
782,陸,阜,11,283,1015745,0.02344701,84.15611900
783,鐘,金,20,283,1016028,0.02344701,84.17956601
784,配,酉,10,282,1016310,0.02336416,84.20293017
785,湖,水,12,282,1016592,0.02336416,84.22629433
786,兵,八,7,281,1016873,0.02328131,84.24957564
787,倍,人,10,281,1017154,0.02328131,84.27285695
788,議,言,20,281,1017435,0.02328131,84.29613826
789,貝,貝,7,280,1017715,0.02319845,84.31933671
790,旁,方,10,280,1017995,0.02319845,84.34253516
791,洞,水,9,278,1018273,0.02303275,84.36556791
792,雪,雨,11,278,1018551,0.02303275,84.38860066
793,賞,貝,15,278,1018829,0.02303275,84.41163341
794,素,糸,10,277,1019106,0.02294990,84.43458331
795,忘,心,7,276,1019382,0.02286705,84.45745036
796,簡,竹,18,276,1019658,0.02286705,84.48031741
797,端,立,14,275,1019933,0.02278420,84.50310161
798,孫,子,10,273,1020206,0.02261849,84.52572010
799,圍,囗,12,273,1020479,0.02261849,84.54833859
800,敬,の,13,273,1020752,0.02261849,84.57095708
801,搖,手,13,273,1021025,0.02261849,84.59357557
802,貓,豸,16,273,1021298,0.02261849,84.61619406
803,隊,阜,12,271,1021569,0.02245279,84.63864685
804,菜,艸,12,271,1021840,0.02245279,84.66109964
805,藥,艸,19,271,1022111,0.02245279,84.68355243
806,顯,頁,23,271,1022382,0.02245279,84.70600522
807,朵,木,6,270,1022652,0.02236994,84.72837516
808,商,口,11,270,1022922,0.02236994,84.75074510
809,獲,犬,17,270,1023192,0.02236994,84.77311504
810,皇,白,9,269,1023461,0.02228709,84.79540213
811,迎,ひ,8,269,1023730,0.02228709,84.81768922
812,露,雨,21,269,1023999,0.02228709,84.83997631
813,仍,人,4,267,1024266,0.02212138,84.86209769
814,幸,干,8,267,1024533,0.02212138,84.88421907
815,鏡,金,19,267,1024800,0.02212138,84.90634045
816,哇,口,9,266,1025066,0.02203853,84.92837898
817,絕,糸,12,266,1025332,0.02203853,84.95041751
818,支,支,4,265,1025597,0.02195568,84.97237319
819,制,刀,8,265,1025862,0.02195568,84.99432887
820,良,艮,7,265,1026127,0.02195568,85.01628455
821,銀,金,14,265,1026392,0.02195568,85.03824023
822,壞,土,19,264,1026656,0.02187283,85.06011306
823,宮,で,10,263,1026919,0.02178998,85.08190304
824,忽,心,8,262,1027181,0.02170712,85.10361016
825,夏,,10,262,1027443,0.02170712,85.12531728
826,復,彳,12,262,1027705,0.02170712,85.14702440
827,止,止,4,261,1027966,0.02162427,85.16864867
828,投,手,7,261,1028227,0.02162427,85.19027294
829,探,手,11,261,1028488,0.02162427,85.21189721
830,冬,ち,5,260,1028748,0.02154142,85.23343863
831,爬,爪,8,260,1029008,0.02154142,85.25498005
832,奏,大,9,260,1029268,0.02154142,85.27652147
833,係,人,9,260,1029528,0.02154142,85.29806289
834,博,十,12,260,1029788,0.02154142,85.31960431
835,乙,乙,1,259,1030047,0.02145857,85.34106288
836,守,で,6,256,1030303,0.02121001,85.36227289
837,局,尸,7,255,1030558,0.02112716,85.38340005
838,乎,ぜ,5,254,1030812,0.02104431,85.40444436
839,液,水,11,254,1031066,0.02104431,85.42548867
840,構,木,14,254,1031320,0.02104431,85.44653298
841,際,阜,14,254,1031574,0.02104431,85.46757729
842,須,頁,12,252,1031826,0.02087861,85.48845590
843,範,竹,15,252,1032078,0.02087861,85.50933451
844,頂,頁,11,251,1032329,0.02079576,85.53013027
845,殺,殳,11,251,1032580,0.02079576,85.55092603
846,獨,犬,16,251,1032831,0.02079576,85.57172179
847,初,衣,8,249,1033080,0.02063005,85.59235184
848,透,ひ,11,249,1033329,0.02063005,85.61298189
849,漢,水,14,249,1033578,0.02063005,85.63361194
850,鬼,鬼,10,247,1033825,0.02046435,85.65407629
851,蛋,虫,11,247,1034072,0.02046435,85.67454064
852,燒,火,16,247,1034319,0.02046435,85.69500499
853,哭,口,10,246,1034565,0.02038150,85.71538649
854,兔,儿,8,245,1034810,0.02029865,85.73568514
855,若,艸,9,245,1035055,0.02029865,85.75598379
856,破,石,10,245,1035300,0.02029865,85.77628244
857,差,工,10,245,1035545,0.02029865,85.79658109
858,顏,頁,18,245,1035790,0.02029865,85.81687974
859,織,糸,18,244,1036034,0.02021580,85.83709554
860,尾,尸,7,244,1036278,0.02021580,85.85731134
861,規,見,11,244,1036522,0.02021580,85.87752714
862,壁,土,16,244,1036766,0.02021580,85.89774294
863,築,竹,16,244,1037010,0.02021580,85.91795874
864,吹,口,7,244,1037254,0.02021580,85.93817454
865,酒,酉,10,243,1037497,0.02013294,85.95830748
866,痛,ば,12,242,1037739,0.02005009,85.97835757
867,防,阜,7,241,1037980,0.01996724,85.99832481
868,勞,力,12,238,1038218,0.01971869,86.01804350
869,珍,玉,9,237,1038455,0.01963583,86.03767933
870,愈,心,13,237,1038692,0.01963583,86.05731516
871,換,手,12,237,1038929,0.01963583,86.07695099
872,漂,水,14,237,1039166,0.01963583,86.09658682
873,岸,山,8,236,1039402,0.01955298,86.11613980
874,昨,日,9,236,1039638,0.01955298,86.13569278
875,倫,人,10,236,1039874,0.01955298,86.15524576
876,遇,ひ,13,236,1040110,0.01955298,86.17479874
877,江,水,6,235,1040345,0.01947013,86.19426887
878,微,彳,13,235,1040580,0.01947013,86.21373900
879,幼,ど,5,234,1040814,0.01938728,86.23312628
880,郎,邑,9,234,1041048,0.01938728,86.25251356
881,榮,木,14,234,1041282,0.01938728,86.27190084
882,歐,欠,15,234,1041516,0.01938728,86.29128812
883,聯,耳,17,234,1041750,0.01938728,86.31067540
884,懷,心,19,234,1041984,0.01938728,86.33006268
885,願,頁,19,234,1042218,0.01938728,86.34944996
886,互,二,4,233,1042451,0.01930443,86.36875439
887,羊,羊,6,232,1042683,0.01922158,86.38797597
888,游,水,12,232,1042915,0.01922158,86.40719755
889,派,水,9,231,1043146,0.01913872,86.42633627
890,梅,木,11,231,1043377,0.01913872,86.44547499
891,蓋,艸,14,231,1043608,0.01913872,86.46461371
892,壓,土,17,231,1043839,0.01913872,86.48375243
893,警,言,20,231,1044070,0.01913872,86.50289115
894,丁,一,2,230,1044300,0.01905587,86.52194702
895,粉,米,10,230,1044530,0.01905587,86.54100289
896,擔,手,16,230,1044760,0.01905587,86.56005876
897,免,儿,7,229,1044989,0.01897302,86.57903178
898,偷,人,11,229,1045218,0.01897302,86.59800480
899,豐,豆,18,229,1045447,0.01897302,86.61697782
900,偉,人,11,228,1045675,0.01889017,86.63586799
901,繼,糸,20,228,1045903,0.01889017,86.65475816
902,季,子,8,227,1046130,0.01880732,86.67356548
903,施,方,9,227,1046357,0.01880732,86.69237280
904,亂,乙,13,227,1046584,0.01880732,86.71118012
905,袋,衣,11,226,1046810,0.01872447,86.72990459
906,窗,穴,12,226,1047036,0.01872447,86.74862906
907,斤,斤,4,225,1047261,0.01864161,86.76727067
908,份,人,6,225,1047486,0.01864161,86.78591228
909,努,力,7,225,1047711,0.01864161,86.80455389
910,島,山,10,225,1047936,0.01864161,86.82319550
911,減,水,12,225,1048161,0.01864161,86.84183711
912,魔,鬼,21,225,1048386,0.01864161,86.86047872
913,巨,工,5,224,1048610,0.01855876,86.87903748
914,仔,人,5,224,1048834,0.01855876,86.89759624
915,負,貝,9,224,1049058,0.01855876,86.91615500
916,追,ひ,10,224,1049282,0.01855876,86.93471376
917,險,阜,16,224,1049506,0.01855876,86.95327252
918,劉,刀,15,223,1049729,0.01847591,86.97174843
919,衛,行,15,222,1049951,0.01839306,86.99014149
920,靠,非,15,222,1050173,0.01839306,87.00853455
921,輪,車,15,221,1050394,0.01831021,87.02684476
922,靈,雨,24,221,1050615,0.01831021,87.04515497
923,楚,木,13,220,1050835,0.01822736,87.06338233
924,叔,又,8,219,1051054,0.01814450,87.08152683
925,齒,齒,15,219,1051273,0.01814450,87.09967133
926,洗,水,9,218,1051491,0.01806165,87.11773298
927,敢,の,12,218,1051709,0.01806165,87.13579463
928,甚,甘,9,217,1051926,0.01797880,87.15377343
929,桃,木,10,217,1052143,0.01797880,87.17175223
930,陣,阜,10,217,1052360,0.01797880,87.18973103
931,章,音,11,217,1052577,0.01797880,87.20770983
932,散,の,12,217,1052794,0.01797880,87.22568863
933,樓,木,15,216,1053010,0.01789595,87.24358458
934,拍,手,8,215,1053225,0.01781310,87.26139768
935,府,な,8,215,1053440,0.01781310,87.27921078
936,符,竹,11,215,1053655,0.01781310,87.29702388
937,介,人,4,214,1053869,0.01773025,87.31475413
938,庭,な,10,214,1054083,0.01773025,87.33248438
939,祖,示,10,214,1054297,0.01773025,87.35021463
940,伸,人,7,213,1054510,0.01764740,87.36786203
941,按,手,9,213,1054723,0.01764740,87.38550943
942,鬧,鬥,15,213,1054936,0.01764740,87.40315683
943,刀,刀,2,212,1055148,0.01756454,87.42072137
944,否,口,7,212,1055360,0.01756454,87.43828591
945,灰,火,6,211,1055571,0.01748169,87.45576760
946,森,木,12,211,1055782,0.01748169,87.47324929
947,揮,手,12,211,1055993,0.01748169,87.49073098
948,彈,弓,15,211,1056204,0.01748169,87.50821267
949,秋,禾,9,210,1056414,0.01739884,87.52561151
950,尋,寸,12,210,1056624,0.01739884,87.54301035
951,編,糸,15,210,1056834,0.01739884,87.56040919
952,營,火,17,210,1057044,0.01739884,87.57780803
953,堅,土,11,209,1057253,0.01731599,87.59512402
954,移,禾,11,209,1057462,0.01731599,87.61244001
955,談,言,15,209,1057671,0.01731599,87.62975600
956,擊,手,17,209,1057880,0.01731599,87.64707199
957,賣,貝,15,208,1058088,0.01723314,87.66430513
958,暖,日,13,207,1058295,0.01715029,87.68145542
959,爭,爪,8,206,1058501,0.01706743,87.69852285
960,紛,糸,10,206,1058707,0.01706743,87.71559028
961,盛,皿,11,205,1058912,0.01698458,87.73257486
962,替,曰,12,205,1059117,0.01698458,87.74955944
963,餐,食,16,205,1059322,0.01698458,87.76654402
964,志,心,7,204,1059526,0.01690173,87.78344575
965,虎,虍,8,204,1059730,0.01690173,87.80034748
966,桌,木,10,204,1059934,0.01690173,87.81724921
967,夢,夕,14,204,1060138,0.01690173,87.83415094
968,耳,耳,6,203,1060341,0.01681888,87.85096982
969,尼,尸,5,203,1060544,0.01681888,87.86778870
970,堡,土,12,203,1060747,0.01681888,87.88460758
971,殼,殳,12,203,1060950,0.01681888,87.90142646
972,杯,木,8,202,1061152,0.01673603,87.91816249
973,堂,土,11,202,1061354,0.01673603,87.93489852
974,圈,囗,11,202,1061556,0.01673603,87.95163455
975,吉,口,6,201,1061757,0.01665318,87.96828773
976,店,な,8,201,1061958,0.01665318,87.98494091
977,乘,ぜ,10,201,1062159,0.01665318,88.00159409
978,值,人,10,201,1062360,0.01665318,88.01824727
979,烈,火,10,201,1062561,0.01665318,88.03490045
980,異,田,11,201,1062762,0.01665318,88.05155363
981,聖,耳,13,201,1062963,0.01665318,88.06820681
982,暗,日,13,200,1063163,0.01657032,88.08477713
983,獎,犬,15,198,1063361,0.01640462,88.10118175
984,嚴,口,20,198,1063559,0.01640462,88.11758637
985,鎮,金,18,198,1063757,0.01640462,88.13399099
986,麻,麻,11,196,1063953,0.01623892,88.15022991
987,兄,儿,5,195,1064148,0.01615607,88.16638598
988,猴,犬,12,195,1064343,0.01615607,88.18254205
989,忍,心,7,194,1064537,0.01607321,88.19861526
990,毒,毋,8,194,1064731,0.01607321,88.21468847
991,悄,心,10,194,1064925,0.01607321,88.23076168
992,秦,禾,10,194,1065119,0.01607321,88.24683489
993,採,手,11,194,1065313,0.01607321,88.26290810
994,床,な,7,193,1065506,0.01599036,88.27889846
995,茶,艸,10,193,1065699,0.01599036,88.29488882
996,滑,水,13,193,1065892,0.01599036,88.31087918
997,聞,耳,14,193,1066085,0.01599036,88.32686954
998,齊,齊,14,193,1066278,0.01599036,88.34285990
999,哦,口,10,192,1066470,0.01590751,88.35876741
1000,雅,隹,12,192,1066662,0.01590751,88.37467492
1001,箱,竹,15,192,1066854,0.01590751,88.39058243
1002,堆,土,11,191,1067045,0.01582466,88.40640709
1003,熟,火,15,191,1067236,0.01582466,88.42223175
1004,沉,水,7,190,1067426,0.01574181,88.43797356
1005,價,人,15,190,1067616,0.01574181,88.45371537
1006,操,手,16,190,1067806,0.01574181,88.46945718
1007,姐,女,8,189,1067995,0.01565896,88.48511614
1008,典,八,8,189,1068184,0.01565896,88.50077510
1009,序,な,7,189,1068373,0.01565896,88.51643406
1010,肯,肉,8,189,1068562,0.01565896,88.53209302
1011,俗,人,9,189,1068751,0.01565896,88.54775198
1012,閃,門,10,189,1068940,0.01565896,88.56341094
1013,票,示,11,189,1069129,0.01565896,88.57906990
1014,頓,頁,13,189,1069318,0.01565896,88.59472886
1015,奮,大,16,188,1069506,0.01557610,88.61030496
1016,壯,士,7,187,1069693,0.01549325,88.62579821
1017,唐,口,10,187,1069880,0.01549325,88.64129146
1018,醒,酉,16,187,1070067,0.01549325,88.65678471
1019,佛,人,7,186,1070253,0.01541040,88.67219511
1020,豆,豆,7,186,1070439,0.01541040,88.68760551
1021,幹,干,13,186,1070625,0.01541040,88.70301591
1022,豬,豕,15,186,1070811,0.01541040,88.71842631
1023,偶,人,11,185,1070996,0.01532755,88.73375386
1024,蛇,虫,11,185,1071181,0.01532755,88.74908141
1025,勢,力,13,185,1071366,0.01532755,88.76440896
1026,括,手,9,184,1071550,0.01524470,88.77965366
1027,紹,糸,11,184,1071734,0.01524470,88.79489836
1028,餘,食,15,184,1071918,0.01524470,88.81014306
1029,徵,彳,15,184,1072102,0.01524470,88.82538776
1030,巧,工,5,183,1072285,0.01516185,88.84054961
1031,某,木,9,183,1072468,0.01516185,88.85571146
1032,釋,釆,20,183,1072651,0.01516185,88.87087331
1033,欣,欠,8,182,1072833,0.01507899,88.88595230
1034,勇,力,9,182,1073015,0.01507899,88.90103129
1035,率,玄,11,182,1073197,0.01507899,88.91611028
1036,寬,で,15,182,1073379,0.01507899,88.93118927
1037,暴,日,15,182,1073561,0.01507899,88.94626826
1038,妙,女,7,181,1073742,0.01499614,88.96126440
1039,災,火,7,181,1073923,0.01499614,88.97626054
1040,索,糸,10,181,1074104,0.01499614,88.99125668
1041,責,貝,11,181,1074285,0.01499614,89.00625282
1042,納,糸,10,179,1074464,0.01483044,89.02108326
1043,瓶,瓦,11,179,1074643,0.01483044,89.03591370
1044,預,頁,13,179,1074822,0.01483044,89.05074414
1045,儀,人,15,179,1075001,0.01483044,89.06557458
1046,懂,心,17,179,1075180,0.01483044,89.08040502
1047,臨,臣,17,179,1075359,0.01483044,89.09523546
1048,橫,木,16,179,1075538,0.01483044,89.11006590
1049,伴,人,7,178,1075716,0.01474759,89.12481349
1050,珠,玉,10,178,1075894,0.01474759,89.13956108
1051,冰,ち,6,177,1076071,0.01466474,89.15422582
1052,降,阜,9,177,1076248,0.01466474,89.16889056
1053,鮮,魚,17,177,1076425,0.01466474,89.18355530
1054,雜,隹,18,177,1076602,0.01466474,89.19822004
1055,智,日,12,177,1076779,0.01466474,89.21288478
1056,雕,隹,16,177,1076956,0.01466474,89.22754952
1057,濟,水,17,177,1077133,0.01466474,89.24221426
1058,泥,水,8,177,1077310,0.01466474,89.25687900
1059,嚇,口,17,177,1077487,0.01466474,89.27154374
1060,彎,弓,22,177,1077664,0.01466474,89.28620848
1061,泡,水,8,176,1077840,0.01458189,89.30079037
1062,軟,車,11,176,1078016,0.01458189,89.31537226
1063,勝,力,12,176,1078192,0.01458189,89.32995415
1064,距,足,12,176,1078368,0.01458189,89.34453604
1065,架,木,9,175,1078543,0.01449903,89.35903507
1066,激,水,16,175,1078718,0.01449903,89.37353410
1067,抱,手,8,174,1078892,0.01441618,89.38795028
1068,秀,禾,7,174,1079066,0.01441618,89.40236646
1069,況,水,8,174,1079240,0.01441618,89.41678264
1070,抓,手,7,173,1079413,0.01433333,89.43111597
1071,婚,女,11,173,1079586,0.01433333,89.44544930
1072,超,走,12,173,1079759,0.01433333,89.45978263
1073,刺,刀,8,172,1079931,0.01425048,89.47403311
1074,描,手,12,172,1080103,0.01425048,89.48828359
1075,惡,心,12,172,1080275,0.01425048,89.50253407
1076,尤,尢,4,171,1080446,0.01416763,89.51670170
1077,戶,戶,4,171,1080617,0.01416763,89.53086933
1078,吳,口,7,171,1080788,0.01416763,89.54503696
1079,逃,ひ,10,171,1080959,0.01416763,89.55920459
1080,氧,气,10,171,1081130,0.01416763,89.57337222
1081,困,囗,7,170,1081300,0.01408478,89.58745700
1082,述,ひ,9,170,1081470,0.01408478,89.60154178
1083,浪,水,10,170,1081640,0.01408478,89.61562656
1084,威,女,9,169,1081809,0.01400192,89.62962848
1085,染,木,9,169,1081978,0.01400192,89.64363040
1086,街,行,12,169,1082147,0.01400192,89.65763232
1087,篇,竹,15,169,1082316,0.01400192,89.67163424
1088,縮,糸,17,169,1082485,0.01400192,89.68563616
1089,聰,耳,17,169,1082654,0.01400192,89.69963808
1090,隔,阜,13,168,1082822,0.01391907,89.71355715
1091,銅,金,14,168,1082990,0.01391907,89.72747622
1092,州,と,6,167,1083157,0.01383622,89.74131244
1093,封,寸,9,167,1083324,0.01383622,89.75514866
1094,致,至,9,167,1083491,0.01383622,89.76898488
1095,貼,貝,12,167,1083658,0.01383622,89.78282110
1096,箭,竹,15,167,1083825,0.01383622,89.79665732
1097,橋,木,16,167,1083992,0.01383622,89.81049354
1098,危,つ,6,166,1084158,0.01375337,89.82424691
1099,孝,子,7,166,1084324,0.01375337,89.83800028
1100,限,阜,9,166,1084490,0.01375337,89.85175365
1101,溪,水,13,166,1084656,0.01375337,89.86550702
1102,鞋,革,15,166,1084822,0.01375337,89.87926039
1103,姓,女,8,165,1084987,0.01367052,89.89293091
1104,烏,火,10,165,1085152,0.01367052,89.90660143
1105,牆,爿,17,165,1085317,0.01367052,89.92027195
1106,猜,犬,11,164,1085481,0.01358767,89.93385962
1107,淡,水,11,164,1085645,0.01358767,89.94744729
1108,敵,の,15,164,1085809,0.01358767,89.96103496
1109,固,囗,8,163,1085972,0.01350481,89.97453977
1110,掃,手,11,163,1086135,0.01350481,89.98804458
1111,逐,ひ,11,163,1086298,0.01350481,90.00154939
1112,勤,力,13,163,1086461,0.01350481,90.01505420
1113,棒,木,12,163,1086624,0.01350481,90.02855901
1114,載,車,13,163,1086787,0.01350481,90.04206382
1115,悟,心,10,162,1086949,0.01342196,90.05548578
1116,效,の,10,162,1087111,0.01342196,90.06890774
1117,普,日,12,162,1087273,0.01342196,90.08232970
1118,姆,女,8,161,1087434,0.01333911,90.09566881
1119,既,は,9,161,1087595,0.01333911,90.10900792
1120,掛,手,11,161,1087756,0.01333911,90.12234703
1121,盒,皿,11,161,1087917,0.01333911,90.13568614
1122,惜,心,11,161,1088078,0.01333911,90.14902525
1123,硬,石,12,161,1088239,0.01333911,90.16236436
1124,播,手,15,161,1088400,0.01333911,90.17570347
1125,慶,心,15,161,1088561,0.01333911,90.18904258
1126,宜,で,8,160,1088721,0.01325626,90.20229884
1127,妻,女,8,160,1088881,0.01325626,90.21555510
1128,獵,犬,18,160,1089041,0.01325626,90.22881136
1129,舊,臼,18,160,1089201,0.01325626,90.24206762
1130,后,口,6,159,1089360,0.01317341,90.25524103
1131,司,口,5,159,1089519,0.01317341,90.26841444
1132,缺,缶,10,159,1089678,0.01317341,90.28158785
1133,淚,水,11,159,1089837,0.01317341,90.29476126
1134,證,言,19,159,1089996,0.01317341,90.30793467
1135,蓮,艸,15,158,1090154,0.01309056,90.32102523
1136,蘇,艸,20,158,1090312,0.01309056,90.33411579
1137,享,ぞ,8,157,1090469,0.01300770,90.34712349
1138,財,貝,10,157,1090626,0.01300770,90.36013119
1139,尊,寸,12,157,1090783,0.01300770,90.37313889
1140,躲,身,13,157,1090940,0.01300770,90.38614659
1141,滴,水,14,157,1091097,0.01300770,90.39915429
1142,翻,羽,18,157,1091254,0.01300770,90.41216199
1143,寄,で,11,156,1091410,0.01292485,90.42508684
1144,遍,ひ,13,156,1091566,0.01292485,90.43801169
1145,繁,糸,17,156,1091722,0.01292485,90.45093654
1146,捕,手,10,155,1091877,0.01284200,90.46377854
1147,登,ぱ,12,155,1092032,0.01284200,90.47662054
1148,煩,火,13,155,1092187,0.01284200,90.48946254
1149,瓜,瓜,5,154,1092341,0.01275915,90.50222169
1150,弄,廾,7,154,1092495,0.01275915,90.51498084
1151,抽,手,8,154,1092649,0.01275915,90.52773999
1152,淨,水,11,154,1092803,0.01275915,90.54049914
1153,窮,穴,15,154,1092957,0.01275915,90.55325829
1154,鋼,金,16,154,1093111,0.01275915,90.56601744
1155,乳,乙,8,153,1093264,0.01267630,90.57869374
1156,厚,厂,9,153,1093417,0.01267630,90.59137004
1157,膠,肉,15,153,1093570,0.01267630,90.60404634
1158,權,木,22,153,1093723,0.01267630,90.61672264
1159,讚,言,26,153,1093876,0.01267630,90.62939894
1160,傑,人,12,152,1094028,0.01259345,90.64199239
1161,髮,髟,15,152,1094180,0.01259345,90.65458584
1162,覽,見,21,152,1094332,0.01259345,90.66717929
1163,均,土,7,151,1094483,0.01251059,90.67968988
1164,剪,刀,11,151,1094634,0.01251059,90.69220047
1165,禁,示,13,151,1094785,0.01251059,90.70471106
1166,汽,水,7,150,1094935,0.01242774,90.71713880
1167,肥,肉,8,150,1095085,0.01242774,90.72956654
1168,雷,雨,13,150,1095235,0.01242774,90.74199428
1169,狼,犬,10,149,1095384,0.01234489,90.75433917
1170,僅,人,13,149,1095533,0.01234489,90.76668406
1171,摸,手,14,149,1095682,0.01234489,90.77902895
1172,鼻,鼻,14,149,1095831,0.01234489,90.79137384
1173,糖,米,16,149,1095980,0.01234489,90.80371873
1174,默,黑,16,149,1096129,0.01234489,90.81606362
1175,婦,女,11,148,1096277,0.01226204,90.82832566
1176,鹿,鹿,11,148,1096425,0.01226204,90.84058770
1177,池,水,6,147,1096572,0.01217919,90.85276689
1178,胡,肉,9,147,1096719,0.01217919,90.86494608
1179,剩,刀,12,147,1096866,0.01217919,90.87712527
1180,聊,耳,11,147,1097013,0.01217919,90.88930446
1181,避,ひ,17,147,1097160,0.01217919,90.90148365
1182,折,手,7,146,1097306,0.01209634,90.91357999
1183,冒,た,9,146,1097452,0.01209634,90.92567633
1184,套,大,10,146,1097598,0.01209634,90.93777267
1185,付,人,5,145,1097743,0.01201348,90.94978615
1186,繩,糸,19,145,1097888,0.01201348,90.96179963
1187,宇,で,6,145,1098033,0.01201348,90.97381311
1188,革,革,9,145,1098178,0.01201348,90.98582659
1189,楊,木,13,145,1098323,0.01201348,90.99784007
1190,舒,舌,12,145,1098468,0.01201348,91.00985355
1191,協,十,8,145,1098613,0.01201348,91.02186703
1192,招,手,8,144,1098757,0.01193063,91.03379766
1193,敗,の,11,144,1098901,0.01193063,91.04572829
1194,蒙,艸,14,144,1099045,0.01193063,91.05765892
1195,億,人,15,144,1099189,0.01193063,91.06958955
1196,廳,な,25,144,1099333,0.01193063,91.08152018
1197,獅,犬,13,143,1099476,0.01184778,91.09336796
1198,肌,肉,6,142,1099618,0.01176493,91.10513289
1199,攻,の,7,142,1099760,0.01176493,91.11689782
1200,訊,言,10,141,1099901,0.01168208,91.12857990
1201,退,ひ,10,141,1100042,0.01168208,91.14026198
1202,徒,彳,10,141,1100183,0.01168208,91.15194406
1203,幣,巾,14,141,1100324,0.01168208,91.16362614
1204,佳,人,8,140,1100464,0.01159923,91.17522537
1205,版,片,8,140,1100604,0.01159923,91.18682460
1206,核,木,10,140,1100744,0.01159923,91.19842383
1207,粗,米,11,140,1100884,0.01159923,91.21002306
1208,腿,肉,14,140,1101024,0.01159923,91.22162229
1209,喊,口,12,139,1101163,0.01151638,91.23313867
1210,補,衣,13,139,1101302,0.01151638,91.24465505
1211,辨,辛,16,139,1101441,0.01151638,91.25617143
1212,繞,糸,18,139,1101580,0.01151638,91.26768781
1213,域,土,11,138,1101718,0.01143352,91.27912133
1214,滾,水,14,138,1101856,0.01143352,91.29055485
1215,獻,犬,20,138,1101994,0.01143352,91.30198837
1216,昆,日,8,137,1102131,0.01135067,91.31333904
1217,洛,水,9,137,1102268,0.01135067,91.32468971
1218,咪,口,9,137,1102405,0.01135067,91.33604038
1219,弱,弓,10,137,1102542,0.01135067,91.34739105
1220,陰,阜,11,137,1102679,0.01135067,91.35874172
1221,莉,艸,11,137,1102816,0.01135067,91.37009239
1222,溶,水,13,137,1102953,0.01135067,91.38144306
1223,滅,水,13,136,1103089,0.01126782,91.39271088
1224,阻,阜,8,135,1103224,0.01118497,91.40389585
1225,訪,言,11,135,1103359,0.01118497,91.41508082
1226,湯,水,12,135,1103494,0.01118497,91.42626579
1227,磁,石,14,135,1103629,0.01118497,91.43745076
1228,遺,ひ,16,135,1103764,0.01118497,91.44863573
1229,宗,で,8,134,1103898,0.01110212,91.45973785
1230,冠,だ,9,134,1104032,0.01110212,91.47083997
1231,紋,糸,10,134,1104166,0.01110212,91.48194209
1232,隆,阜,12,134,1104300,0.01110212,91.49304421
1233,潔,水,15,134,1104434,0.01110212,91.50414633
1234,郵,邑,12,133,1104567,0.01101927,91.51516560
1235,尚,小,8,133,1104700,0.01101927,91.52618487
1236,粒,米,11,133,1104833,0.01101927,91.53720414
1237,斜,斗,11,133,1104966,0.01101927,91.54822341
1238,裂,衣,12,133,1105099,0.01101927,91.55924268
1239,沿,水,8,133,1105232,0.01101927,91.57026195
1240,誠,言,13,133,1105365,0.01101927,91.58128122
1241,碼,石,15,133,1105498,0.01101927,91.59230049
1242,慧,心,15,133,1105631,0.01101927,91.60331976
1243,擺,手,18,133,1105764,0.01101927,91.61433903
1244,側,人,11,132,1105896,0.01093641,91.62527544
1245,借,人,10,132,1106028,0.01093641,91.63621185
1246,掌,手,12,132,1106160,0.01093641,91.64714826
1247,奧,大,13,132,1106292,0.01093641,91.65808467
1248,稻,禾,15,132,1106424,0.01093641,91.66902108
1249,丹,せ,4,131,1106555,0.01085356,91.67987464
1250,松,木,8,130,1106685,0.01077071,91.69064535
1251,抬,手,8,130,1106815,0.01077071,91.70141606
1252,揚,手,12,130,1106945,0.01077071,91.71218677
1253,潮,水,15,130,1107075,0.01077071,91.72295748
1254,犯,犬,5,129,1107204,0.01068786,91.73364534
1255,呈,口,7,129,1107333,0.01068786,91.74433320
1256,挑,手,9,129,1107462,0.01068786,91.75502106
1257,胞,肉,9,129,1107591,0.01068786,91.76570892
1258,貨,貝,11,129,1107720,0.01068786,91.77639678
1259,脫,肉,11,129,1107849,0.01068786,91.78708464
1260,嘛,口,14,129,1107978,0.01068786,91.79777250
1261,鈴,金,13,129,1108107,0.01068786,91.80846036
1262,藉,艸,18,129,1108236,0.01068786,91.81914822
1263,末,木,5,128,1108364,0.01060501,91.82975323
1264,君,口,7,128,1108492,0.01060501,91.84035824
1265,衝,行,15,128,1108620,0.01060501,91.85096325
1266,魯,魚,15,128,1108748,0.01060501,91.86156826
1267,鵝,鳥,18,128,1108876,0.01060501,91.87217327
1268,尖,小,6,127,1109003,0.01052216,91.88269543
1269,束,木,7,127,1109130,0.01052216,91.89321759
1270,恩,心,10,127,1109257,0.01052216,91.90373975
1271,胸,肉,10,127,1109384,0.01052216,91.91426191
1272,貌,豸,14,127,1109511,0.01052216,91.92478407
1273,臟,肉,22,127,1109638,0.01052216,91.93530623
1274,觸,角,20,127,1109765,0.01052216,91.94582839
1275,仁,人,4,126,1109891,0.01043930,91.95626769
1276,垂,土,9,126,1110017,0.01043930,91.96670699
1277,娃,女,9,126,1110143,0.01043930,91.97714629
1278,殊,歹,10,126,1110269,0.01043930,91.98758559
1279,概,木,13,126,1110395,0.01043930,91.99802489
1280,閱,門,15,126,1110521,0.01043930,92.00846419
1281,肚,肉,7,125,1110646,0.01035645,92.01882064
1282,祥,示,11,125,1110771,0.01035645,92.02917709
1283,閒,門,12,125,1110896,0.01035645,92.03953354
1284,蒸,艸,14,125,1111021,0.01035645,92.04988999
1285,璃,玉,15,125,1111146,0.01035645,92.06024644
1286,擦,手,17,125,1111271,0.01035645,92.07060289
1287,丟,一,6,124,1111395,0.01027360,92.08087649
1288,柱,木,9,124,1111519,0.01027360,92.09115009
1289,啟,の,11,124,1111643,0.01027360,92.10142369
1290,棉,木,12,124,1111767,0.01027360,92.11169729
1291,誕,言,15,124,1111891,0.01027360,92.12197089
1292,濃,水,16,124,1112015,0.01027360,92.13224449
1293,鹽,鹵,24,124,1112139,0.01027360,92.14251809
1294,爛,火,21,124,1112263,0.01027360,92.15279169
1295,憶,心,16,123,1112386,0.01019075,92.16298244
1296,甘,甘,5,123,1112509,0.01019075,92.17317319
1297,悲,心,12,123,1112632,0.01019075,92.18336394
1298,莊,艸,11,123,1112755,0.01019075,92.19355469
1299,蒂,艸,13,123,1112878,0.01019075,92.20374544
1300,玻,玉,9,123,1113001,0.01019075,92.21393619
1301,龜,龜,16,123,1113124,0.01019075,92.22412694
1302,檢,木,17,123,1113247,0.01019075,92.23431769
1303,卵,つ,7,122,1113369,0.01010790,92.24442559
1304,芬,艸,8,122,1113491,0.01010790,92.25453349
1305,徑,彳,10,122,1113613,0.01010790,92.26464139
1306,益,皿,10,122,1113735,0.01010790,92.27474929
1307,煙,火,13,122,1113857,0.01010790,92.28485719
1308,階,阜,12,122,1113979,0.01010790,92.29496509
1309,緣,糸,15,122,1114101,0.01010790,92.30507299
1310,歸,止,18,122,1114223,0.01010790,92.31518089
1311,宙,で,8,121,1114344,0.01002505,92.32520594
1312,股,肉,8,121,1114465,0.01002505,92.33523099
1313,捉,手,10,121,1114586,0.01002505,92.34525604
1314,旋,方,11,121,1114707,0.01002505,92.35528109
1315,鳳,鳥,14,121,1114828,0.01002505,92.36530614
1316,複,衣,15,121,1114949,0.01002505,92.37533119
1317,鄰,邑,15,121,1115070,0.01002505,92.38535624
1318,糕,米,16,121,1115191,0.01002505,92.39538129
1319,勵,力,17,121,1115312,0.01002505,92.40540634
1320,燃,火,16,121,1115433,0.01002505,92.41543139
1321,亡,ぞ,3,120,1115553,0.00994219,92.42537358
1322,臣,臣,6,120,1115673,0.00994219,92.43531577
1323,谷,谷,7,120,1115793,0.00994219,92.44525796
1324,律,彳,9,120,1115913,0.00994219,92.45520015
1325,陶,阜,11,120,1116033,0.00994219,92.46514234
1326,莫,艸,11,120,1116153,0.00994219,92.47508453
1327,膀,肉,14,119,1116272,0.00985934,92.48494387
1328,疑,疋,14,119,1116391,0.00985934,92.49480321
1329,聚,耳,14,119,1116510,0.00985934,92.50466255
1330,績,糸,17,119,1116629,0.00985934,92.51452189
1331,繪,糸,19,119,1116748,0.00985934,92.52438123
1332,飄,風,20,119,1116867,0.00985934,92.53424057
1333,昏,日,8,118,1116985,0.00977649,92.54401706
1334,涼,水,11,118,1117103,0.00977649,92.55379355
1335,累,糸,11,118,1117221,0.00977649,92.56357004
1336,途,ひ,11,118,1117339,0.00977649,92.57334653
1337,混,水,11,118,1117457,0.00977649,92.58312302
1338,港,水,12,118,1117575,0.00977649,92.59289951
1339,瑪,玉,14,118,1117693,0.00977649,92.60267600
1340,鋒,金,15,118,1117811,0.00977649,92.61245249
1341,融,虫,16,118,1117929,0.00977649,92.62222898
1342,隱,阜,17,118,1118047,0.00977649,92.63200547
1343,週,ひ,12,117,1118164,0.00969364,92.64169911
1344,酸,酉,14,117,1118281,0.00969364,92.65139275
1345,砍,石,9,117,1118398,0.00969364,92.66108639
1346,巢,と,11,117,1118515,0.00969364,92.67078003
1347,萊,艸,12,117,1118632,0.00969364,92.68047367
1348,坡,土,8,117,1118749,0.00969364,92.69016731
1349,浮,水,10,117,1118866,0.00969364,92.69986095
1350,輸,車,16,117,1118983,0.00969364,92.70955459
1351,址,土,7,116,1119099,0.00961079,92.71916538
1352,柔,木,9,116,1119215,0.00961079,92.72877617
1353,搬,手,13,116,1119331,0.00961079,92.73838696
1354,餓,食,15,116,1119447,0.00961079,92.74799775
1355,蝶,虫,15,116,1119563,0.00961079,92.75760854
1356,獸,犬,19,116,1119679,0.00961079,92.76721933
1357,汗,水,6,115,1119794,0.00952794,92.77674727
1358,曹,曰,11,115,1119909,0.00952794,92.78627521
1359,毫,毛,11,115,1120024,0.00952794,92.79580315
1360,棵,木,12,115,1120139,0.00952794,92.80533109
1361,嗯,口,13,115,1120254,0.00952794,92.81485903
1362,戴,戈,17,115,1120369,0.00952794,92.82438697
1363,鷹,鳥,24,115,1120484,0.00952794,92.83391491
1364,碎,石,13,114,1120598,0.00944508,92.84335999
1365,籃,竹,20,114,1120712,0.00944508,92.85280507
1366,延,に,8,113,1120825,0.00936223,92.86216730
1367,抗,手,7,113,1120938,0.00936223,92.87152953
1368,恭,心,10,113,1121051,0.00936223,92.88089176
1369,插,手,12,113,1121164,0.00936223,92.89025399
1370,塔,土,13,113,1121277,0.00936223,92.89961622
1371,鴨,鳥,16,113,1121390,0.00936223,92.90897845
1372,仿,人,6,112,1121502,0.00927938,92.91825783
1373,判,刀,7,112,1121614,0.00927938,92.92753721
1374,翅,羽,10,112,1121726,0.00927938,92.93681659
1375,愉,心,12,112,1121838,0.00927938,92.94609597
1376,晨,日,11,112,1121950,0.00927938,92.95537535
1377,蛙,虫,12,112,1122062,0.00927938,92.96465473
1378,慈,心,13,112,1122174,0.00927938,92.97393411
1379,耕,耒,10,111,1122285,0.00919653,92.98313064
1380,筋,竹,12,111,1122396,0.00919653,92.99232717
1381,漁,水,14,111,1122507,0.00919653,93.00152370
1382,燕,火,16,111,1122618,0.00919653,93.01072023
1383,騎,馬,18,111,1122729,0.00919653,93.01991676
1384,芳,艸,8,110,1122839,0.00911368,93.02903044
1385,偏,人,11,110,1122949,0.00911368,93.03814412
1386,訓,言,10,110,1123059,0.00911368,93.04725780
1387,敘,の,11,110,1123169,0.00911368,93.05637148
1388,陪,阜,11,110,1123279,0.00911368,93.06548516
1389,暑,日,12,110,1123389,0.00911368,93.07459884
1390,墨,黑,15,110,1123499,0.00911368,93.08371252
1391,燭,火,17,110,1123609,0.00911368,93.09282620
1392,臂,肉,17,110,1123719,0.00911368,93.10193988
1393,匹,っ,4,109,1123828,0.00903083,93.11097071
1394,佩,人,8,109,1123937,0.00903083,93.12000154
1395,迪,ひ,9,109,1124046,0.00903083,93.12903237
1396,秒,禾,9,109,1124155,0.00903083,93.13806320
1397,評,言,12,109,1124264,0.00903083,93.14709403
1398,塑,土,13,109,1124373,0.00903083,93.15612486
1399,輔,車,14,109,1124482,0.00903083,93.16515569
1400,磨,石,16,109,1124591,0.00903083,93.17418652
1401,螺,虫,17,109,1124700,0.00903083,93.18321735
1402,職,耳,18,109,1124809,0.00903083,93.19224818
1403,珊,玉,9,108,1124917,0.00894797,93.20119615
1404,誤,言,14,108,1125025,0.00894797,93.21014412
1405,奔,大,8,107,1125132,0.00886512,93.21900924
1406,拔,手,8,107,1125239,0.00886512,93.22787436
1407,析,木,8,107,1125346,0.00886512,93.23673948
1408,朗,月,10,107,1125453,0.00886512,93.24560460
1409,梯,木,11,107,1125560,0.00886512,93.25446972
1410,遭,ひ,15,107,1125667,0.00886512,93.26333484
1411,鬆,髟,18,107,1125774,0.00886512,93.27219996
1412,蘿,艸,23,107,1125881,0.00886512,93.28106508
1413,○,囗,1,106,1125987,0.00878227,93.28984735
1414,奉,大,8,106,1126093,0.00878227,93.29862962
1415,屆,尸,8,106,1126199,0.00878227,93.30741189
1416,霧,雨,19,106,1126305,0.00878227,93.31619416
1417,宋,で,7,106,1126411,0.00878227,93.32497643
1418,捨,手,11,106,1126517,0.00878227,93.33375870
1419,碰,石,13,106,1126623,0.00878227,93.34254097
1420,瞧,目,17,106,1126729,0.00878227,93.35132324
1421,炮,火,9,106,1126835,0.00878227,93.36010551
1422,礦,石,20,106,1126941,0.00878227,93.36888778
1423,凡,せ,3,105,1127046,0.00869942,93.37758720
1424,託,言,10,105,1127151,0.00869942,93.38628662
1425,略,田,11,105,1127256,0.00869942,93.39498604
1426,握,手,12,105,1127361,0.00869942,93.40368546
1427,闊,門,17,105,1127466,0.00869942,93.41238488
1428,副,刀,11,104,1127570,0.00861657,93.42100145
1429,脈,肉,10,104,1127674,0.00861657,93.42961802
1430,嘉,口,14,104,1127778,0.00861657,93.43823459
1431,廠,な,15,104,1127882,0.00861657,93.44685116
1432,衡,行,16,104,1127986,0.00861657,93.45546773
1433,川,と,3,103,1128089,0.00853372,93.46400145
1434,央,大,5,103,1128192,0.00853372,93.47253517
1435,丈,一,3,103,1128295,0.00853372,93.48106889
1436,彼,彳,8,103,1128398,0.00853372,93.48960261
1437,鬥,鬥,10,103,1128501,0.00853372,93.49813633
1438,雀,隹,11,103,1128604,0.00853372,93.50667005
1439,熊,火,14,103,1128707,0.00853372,93.51520377
1440,廟,な,15,103,1128810,0.00853372,93.52373749
1441,趙,走,14,103,1128913,0.00853372,93.53227121
1442,承,手,8,102,1129015,0.00845087,93.54072208
1443,扇,戶,10,102,1129117,0.00845087,93.54917295
1444,嘆,口,14,102,1129219,0.00845087,93.55762382
1445,憐,心,15,102,1129321,0.00845087,93.56607469
1446,噴,口,15,102,1129423,0.00845087,93.57452556
1447,囉,口,22,102,1129525,0.00845087,93.58297643
1448,穴,穴,5,101,1129626,0.00836801,93.59134444
1449,氏,氏,4,101,1129727,0.00836801,93.59971245
1450,托,手,6,101,1129828,0.00836801,93.60808046
1451,佈,人,7,101,1129929,0.00836801,93.61644847
1452,埋,土,10,101,1130030,0.00836801,93.62481648
1453,柴,木,10,101,1130131,0.00836801,93.63318449
1454,徐,彳,10,101,1130232,0.00836801,93.64155250
1455,壺,士,12,101,1130333,0.00836801,93.64992051
1456,番,田,12,101,1130434,0.00836801,93.65828852
1457,罪,网,13,101,1130535,0.00836801,93.66665653
1458,炎,火,8,100,1130635,0.00828516,93.67494169
1459,虛,虍,12,100,1130735,0.00828516,93.68322685
1460,蔔,艸,15,100,1130835,0.00828516,93.69151201
1461,賴,貝,16,100,1130935,0.00828516,93.69979717
1462,謎,言,17,100,1131035,0.00828516,93.70808233
1463,挖,手,9,99,1131134,0.00820231,93.71628464
1464,麥,麥,11,99,1131233,0.00820231,93.72448695
1465,塞,土,13,99,1131332,0.00820231,93.73268926
1466,椅,木,12,99,1131431,0.00820231,93.74089157
1467,縫,糸,17,99,1131530,0.00820231,93.74909388
1468,擠,手,17,99,1131629,0.00820231,93.75729619
1469,穫,禾,19,99,1131728,0.00820231,93.76549850
1470,哲,口,10,98,1131826,0.00811946,93.77361796
1471,飽,食,13,98,1131924,0.00811946,93.78173742
1472,曉,日,16,98,1132022,0.00811946,93.78985688
1473,頸,頁,16,98,1132120,0.00811946,93.79797634
1474,蟻,虫,19,98,1132218,0.00811946,93.80609580
1475,吐,口,6,97,1132315,0.00803661,93.81413241
1476,妮,女,8,97,1132412,0.00803661,93.82216902
1477,攝,手,21,97,1132509,0.00803661,93.83020563
1478,莖,艸,11,97,1132606,0.00803661,93.83824224
1479,蜜,虫,14,97,1132703,0.00803661,93.84627885
1480,晶,日,12,97,1132800,0.00803661,93.85431546
1481,紫,糸,12,97,1132897,0.00803661,93.86235207
1482,飾,食,13,97,1132994,0.00803661,93.87038868
1483,猩,犬,12,97,1133091,0.00803661,93.87842529
1484,廢,な,15,97,1133188,0.00803661,93.88646190
1485,橡,木,16,97,1133285,0.00803661,93.89449851
1486,邀,ひ,17,97,1133382,0.00803661,93.90253512
1487,黏,黍,17,97,1133479,0.00803661,93.91057173
1488,帽,巾,12,97,1133576,0.00803661,93.91860834
1489,孟,子,8,96,1133672,0.00795376,93.92656210
1490,曆,日,16,96,1133768,0.00795376,93.93451586
1491,庫,な,10,96,1133864,0.00795376,93.94246962
1492,零,雨,13,96,1133960,0.00795376,93.95042338
1493,寧,で,14,96,1134056,0.00795376,93.95837714
1494,芽,艸,8,96,1134152,0.00795376,93.96633090
1495,叢,又,18,96,1134248,0.00795376,93.97428466
1496,覆,襾,18,96,1134344,0.00795376,93.98223842
1497,京,ぞ,8,95,1134439,0.00787090,93.99010932
1498,耐,而,9,95,1134534,0.00787090,93.99798022
1499,腹,肉,13,95,1134629,0.00787090,94.00585112
1500,夕,夕,3,94,1134723,0.00778805,94.01363917
1501,擇,手,16,94,1134817,0.00778805,94.02142722
1502,胃,肉,9,94,1134911,0.00778805,94.02921527
1503,筒,竹,12,94,1135005,0.00778805,94.03700332
1504,軸,車,12,94,1135099,0.00778805,94.04479137
1505,漫,水,14,94,1135193,0.00778805,94.05257942
1506,惠,心,12,94,1135287,0.00778805,94.06036747
1507,鑽,金,27,94,1135381,0.00778805,94.06815552
1508,瓦,瓦,5,93,1135474,0.00770520,94.07586072
1509,恆,心,9,93,1135567,0.00770520,94.08356592
1510,祭,示,11,93,1135660,0.00770520,94.09127112
1511,跡,足,13,93,1135753,0.00770520,94.09897632
1512,蟹,虫,19,93,1135846,0.00770520,94.10668152
1513,灌,水,21,93,1135939,0.00770520,94.11438672
1514,妖,女,7,92,1136031,0.00762235,94.12200907
1515,咬,口,9,92,1136123,0.00762235,94.12963142
1516,甜,甘,11,92,1136215,0.00762235,94.13725377
1517,搭,手,13,92,1136307,0.00762235,94.14487612
1518,矮,矢,13,92,1136399,0.00762235,94.15249847
1519,棲,木,12,91,1136490,0.00753950,94.16003797
1520,策,竹,12,91,1136581,0.00753950,94.16757747
1521,慌,心,13,91,1136672,0.00753950,94.17511697
1522,監,皿,14,91,1136763,0.00753950,94.18265647
1523,羽,羽,6,90,1136853,0.00745665,94.19011312
1524,忠,心,8,90,1136943,0.00745665,94.19756977
1525,諸,言,15,90,1137033,0.00745665,94.20502642
1526,耶,耳,9,90,1137123,0.00745665,94.21248307
1527,猛,犬,11,90,1137213,0.00745665,94.21993972
1528,損,手,13,90,1137303,0.00745665,94.22739637
1529,殖,歹,12,90,1137393,0.00745665,94.23485302
1530,埃,土,10,90,1137483,0.00745665,94.24230967
1531,膚,肉,15,90,1137573,0.00745665,94.24976632
1532,擁,手,16,90,1137663,0.00745665,94.25722297
1533,井,二,4,89,1137752,0.00737379,94.26459676
1534,哺,口,10,89,1137841,0.00737379,94.27197055
1535,蜂,虫,13,89,1137930,0.00737379,94.27934434
1536,舅,臼,13,89,1138019,0.00737379,94.28671813
1537,懶,心,19,89,1138108,0.00737379,94.29409192
1538,墓,土,14,89,1138197,0.00737379,94.30146571
1539,鉛,金,13,89,1138286,0.00737379,94.30883950
1540,劍,刀,15,89,1138375,0.00737379,94.31621329
1541,蕭,艸,16,89,1138464,0.00737379,94.32358708
1542,翠,羽,14,89,1138553,0.00737379,94.33096087
1543,沖,水,7,88,1138641,0.00729094,94.33825181
1544,貧,貝,11,88,1138729,0.00729094,94.34554275
1545,嫁,女,13,88,1138817,0.00729094,94.35283369
1546,綱,糸,14,88,1138905,0.00729094,94.36012463
1547,蔡,艸,15,88,1138993,0.00729094,94.36741557
1548,賓,貝,14,88,1139081,0.00729094,94.37470651
1549,撞,手,15,88,1139169,0.00729094,94.38199745
1550,爵,爪,17,88,1139257,0.00729094,94.38928839
1551,麵,麥,20,88,1139345,0.00729094,94.39657933
1552,耀,羽,20,88,1139433,0.00729094,94.40387027
1553,吵,口,7,87,1139520,0.00720809,94.41107836
1554,幽,ど,9,87,1139607,0.00720809,94.41828645
1555,翁,羽,10,87,1139694,0.00720809,94.42549454
1556,貫,貝,11,87,1139781,0.00720809,94.43270263
1557,敲,の,14,87,1139868,0.00720809,94.43991072
1558,緩,糸,15,87,1139955,0.00720809,94.44711881
1559,壤,土,20,87,1140042,0.00720809,94.45432690
1560,騙,馬,19,87,1140129,0.00720809,94.46153499
1561,腸,肉,13,86,1140215,0.00712524,94.46866023
1562,侍,人,8,86,1140301,0.00712524,94.47578547
1563,貢,貝,10,86,1140387,0.00712524,94.48291071
1564,疏,疋,11,86,1140473,0.00712524,94.49003595
1565,詳,言,13,86,1140559,0.00712524,94.49716119
1566,柳,木,9,86,1140645,0.00712524,94.50428643
1567,伙,人,6,85,1140730,0.00704239,94.51132882
1568,叮,口,5,85,1140815,0.00704239,94.51837121
1569,呵,口,8,85,1140900,0.00704239,94.52541360
1570,委,女,8,85,1140985,0.00704239,94.53245599
1571,牧,牛,8,85,1141070,0.00704239,94.53949838
1572,航,舟,10,85,1141155,0.00704239,94.54654077
1573,勒,力,11,85,1141240,0.00704239,94.55358316
1574,幅,巾,12,85,1141325,0.00704239,94.56062555
1575,牌,片,12,85,1141410,0.00704239,94.56766794
1576,欄,木,21,85,1141495,0.00704239,94.57471033
1577,占,卜,5,84,1141579,0.00695954,94.58166987
1578,寺,寸,6,84,1141663,0.00695954,94.58862941
1579,伊,人,6,84,1141747,0.00695954,94.59558895
1580,刷,刀,8,84,1141831,0.00695954,94.60254849
1581,訂,言,9,84,1141915,0.00695954,94.60950803
1582,侵,人,9,84,1141999,0.00695954,94.61646757
1583,捲,手,11,84,1142083,0.00695954,94.62342711
1584,傻,人,13,84,1142167,0.00695954,94.63038665
1585,賢,貝,15,84,1142251,0.00695954,94.63734619
1586,呆,口,7,83,1142334,0.00687668,94.64422287
1587,舍,舌,8,83,1142417,0.00687668,94.65109955
1588,晴,日,12,83,1142500,0.00687668,94.65797623
1589,搶,手,13,83,1142583,0.00687668,94.66485291
1590,翔,羽,12,83,1142666,0.00687668,94.67172959
1591,瑞,玉,13,83,1142749,0.00687668,94.67860627
1592,菌,艸,12,83,1142832,0.00687668,94.68548295
1593,劃,刀,14,83,1142915,0.00687668,94.69235963
1594,幕,巾,14,83,1142998,0.00687668,94.69923631
1595,撒,手,15,83,1143081,0.00687668,94.70611299
1596,蠟,虫,21,83,1143164,0.00687668,94.71298967
1597,籠,竹,22,82,1143246,0.00679383,94.71978350
1598,斗,斗,4,82,1143328,0.00679383,94.72657733
1599,蚊,虫,10,82,1143410,0.00679383,94.73337116
1600,閉,門,11,82,1143492,0.00679383,94.74016499
1601,遲,ひ,16,82,1143574,0.00679383,94.74695882
1602,胎,肉,9,82,1143656,0.00679383,94.75375265
1603,蘋,艸,20,82,1143738,0.00679383,94.76054648
1604,丙,一,5,81,1143819,0.00671098,94.76725746
1605,朱,木,6,81,1143900,0.00671098,94.77396844
1606,唉,口,10,81,1143981,0.00671098,94.78067942
1607,倆,人,10,81,1144062,0.00671098,94.78739040
1608,迴,ひ,10,81,1144143,0.00671098,94.79410138
1609,旗,方,14,81,1144224,0.00671098,94.80081236
1610,罵,网,15,81,1144305,0.00671098,94.80752334
1611,鳴,鳥,14,81,1144386,0.00671098,94.81423432
1612,諾,言,16,81,1144467,0.00671098,94.82094530
1613,騰,馬,20,81,1144548,0.00671098,94.82765628
1614,怒,心,9,80,1144628,0.00662813,94.83428441
1615,授,手,11,80,1144708,0.00662813,94.84091254
1616,慮,心,15,80,1144788,0.00662813,94.84754067
1617,遷,ひ,15,80,1144868,0.00662813,94.85416880
1618,餅,食,14,80,1144948,0.00662813,94.86079693
1619,障,阜,14,80,1145028,0.00662813,94.86742506
1620,辭,辛,19,80,1145108,0.00662813,94.87405319
1621,促,人,9,79,1145187,0.00654528,94.88059847
1622,幻,ど,4,79,1145266,0.00654528,94.88714375
1623,吞,口,7,79,1145345,0.00654528,94.89368903
1624,私,禾,7,79,1145424,0.00654528,94.90023431
1625,郊,邑,9,79,1145503,0.00654528,94.90677959
1626,汁,水,5,79,1145582,0.00654528,94.91332487
1627,循,彳,12,79,1145661,0.00654528,94.91987015
1628,奪,大,14,79,1145740,0.00654528,94.92641543
1629,輩,車,15,79,1145819,0.00654528,94.93296071
1630,蝦,虫,15,79,1145898,0.00654528,94.93950599
1631,扁,戶,9,78,1145976,0.00646243,94.94596842
1632,偵,人,11,78,1146054,0.00646243,94.95243085
1633,廚,な,15,78,1146132,0.00646243,94.95889328
1634,縱,糸,17,78,1146210,0.00646243,94.96535571
1635,斑,文,12,78,1146288,0.00646243,94.97181814
1636,渡,水,12,78,1146366,0.00646243,94.97828057
1637,塵,土,14,78,1146444,0.00646243,94.98474300
1638,棄,木,11,78,1146522,0.00646243,94.99120543
1639,飲,食,12,78,1146600,0.00646243,94.99766786
1640,疊,田,22,78,1146678,0.00646243,95.00413029
1641,冊,た,5,77,1146755,0.00637957,95.01050986
1642,俊,人,9,77,1146832,0.00637957,95.01688943
1643,姿,女,9,77,1146909,0.00637957,95.02326900
1644,哩,口,10,77,1146986,0.00637957,95.02964857
1645,榕,木,14,77,1147063,0.00637957,95.03602814
1646,槍,木,14,77,1147140,0.00637957,95.04240771
1647,勸,力,20,77,1147217,0.00637957,95.04878728
1648,鞭,革,18,77,1147294,0.00637957,95.05516685
1649,仰,人,6,76,1147370,0.00629672,95.06146357
1650,拖,手,8,76,1147446,0.00629672,95.06776029
1651,振,手,10,76,1147522,0.00629672,95.07405701
1652,羞,羊,11,76,1147598,0.00629672,95.08035373
1653,塗,土,13,76,1147674,0.00629672,95.08665045
1654,綿,糸,14,76,1147750,0.00629672,95.09294717
1655,壽,士,14,76,1147826,0.00629672,95.09924389
1656,憑,心,16,76,1147902,0.00629672,95.10554061
1657,躺,身,15,76,1147978,0.00629672,95.11183733
1658,雌,隹,14,76,1148054,0.00629672,95.11813405
1659,翼,羽,17,76,1148130,0.00629672,95.12443077
1660,額,頁,18,76,1148206,0.00629672,95.13072749
1661,爆,火,19,76,1148282,0.00629672,95.13702421
1662,杜,木,7,75,1148357,0.00621387,95.14323808
1663,咦,口,9,75,1148432,0.00621387,95.14945195
1664,恨,心,9,75,1148507,0.00621387,95.15566582
1665,荊,艸,10,75,1148582,0.00621387,95.16187969
1666,慣,心,14,75,1148657,0.00621387,95.16809356
1667,輝,車,15,75,1148732,0.00621387,95.17430743
1668,簿,竹,19,75,1148807,0.00621387,95.18052130
1669,躍,足,21,75,1148882,0.00621387,95.18673517
1670,殘,歹,12,74,1148956,0.00613102,95.19286619
1671,伏,人,6,74,1149030,0.00613102,95.19899721
1672,竿,竹,9,74,1149104,0.00613102,95.20512823
1673,泉,水,9,74,1149178,0.00613102,95.21125925
1674,席,巾,10,74,1149252,0.00613102,95.21739027
1675,巡,ひ,7,74,1149326,0.00613102,95.22352129
1676,煤,火,13,74,1149400,0.00613102,95.22965231
1677,溼,水,13,74,1149474,0.00613102,95.23578333
1678,蘆,艸,20,74,1149548,0.00613102,95.24191435
1679,匠,匚,6,73,1149621,0.00604817,95.24796252
1680,拼,手,9,73,1149694,0.00604817,95.25401069
1681,肺,肉,8,73,1149767,0.00604817,95.26005886
1682,骼,骨,16,73,1149840,0.00604817,95.26610703
1683,洪,水,9,73,1149913,0.00604817,95.27215520
1684,釘,金,10,73,1149986,0.00604817,95.27820337
1685,凱,几,12,73,1150059,0.00604817,95.28425154
1686,厲,厂,15,73,1150132,0.00604817,95.29029971
1687,恥,心,10,73,1150205,0.00604817,95.29634788
1688,薄,艸,17,73,1150278,0.00604817,95.30239605
1689,舌,舌,6,72,1150350,0.00596532,95.30836137
1690,夾,大,7,72,1150422,0.00596532,95.31432669
1691,肩,肉,8,72,1150494,0.00596532,95.32029201
1692,枯,木,9,72,1150566,0.00596532,95.32625733
1693,帥,巾,9,72,1150638,0.00596532,95.33222265
1694,稀,禾,12,72,1150710,0.00596532,95.33818797
1695,柏,木,9,72,1150782,0.00596532,95.34415329
1696,殿,殳,13,72,1150854,0.00596532,95.35011861
1697,晃,日,10,72,1150926,0.00596532,95.35608393
1698,渾,水,12,72,1150998,0.00596532,95.36204925
1699,培,土,11,72,1151070,0.00596532,95.36801457
1700,嘿,口,15,72,1151142,0.00596532,95.37397989
1701,荷,艸,11,72,1151214,0.00596532,95.37994521
1702,擴,手,18,72,1151286,0.00596532,95.38591053
1703,傘,人,12,72,1151358,0.00596532,95.39187585
1704,傲,人,13,72,1151430,0.00596532,95.39784117
1705,狐,犬,8,72,1151502,0.00596532,95.40380649
1706,娥,女,10,72,1151574,0.00596532,95.40977181
1707,峽,山,10,72,1151646,0.00596532,95.41573713
1708,敝,の,11,72,1151718,0.00596532,95.42170245
1709,喻,口,12,72,1151790,0.00596532,95.42766777
1710,于,二,3,71,1151861,0.00588247,95.43355024
1711,汙,水,6,71,1151932,0.00588247,95.43943271
1712,刊,刀,5,71,1152003,0.00588247,95.44531518
1713,姜,女,9,71,1152074,0.00588247,95.45119765
1714,宣,で,9,71,1152145,0.00588247,95.45708012
1715,屏,尸,9,71,1152216,0.00588247,95.46296259
1716,淺,水,11,71,1152287,0.00588247,95.46884506
1717,崇,山,11,71,1152358,0.00588247,95.47472753
1718,潑,水,15,71,1152429,0.00588247,95.48061000
1719,煮,火,12,71,1152500,0.00588247,95.48649247
1720,賀,貝,12,71,1152571,0.00588247,95.49237494
1721,豪,豕,14,71,1152642,0.00588247,95.49825741
1722,踏,足,15,71,1152713,0.00588247,95.50413988
1723,絡,糸,12,71,1152784,0.00588247,95.51002235
1724,譜,言,19,71,1152855,0.00588247,95.51590482
1725,蹟,足,18,71,1152926,0.00588247,95.52178729
1726,艾,艸,6,70,1152996,0.00579961,95.52758690
1727,乃,ぜ,2,70,1153066,0.00579961,95.53338651
1728,孤,子,8,70,1153136,0.00579961,95.53918612
1729,虹,虫,9,70,1153206,0.00579961,95.54498573
1730,詹,言,13,70,1153276,0.00579961,95.55078534
1731,嘗,口,14,70,1153346,0.00579961,95.55658495
1732,映,日,9,70,1153416,0.00579961,95.56238456
1733,喲,口,12,70,1153486,0.00579961,95.56818417
1734,悶,心,12,70,1153556,0.00579961,95.57398378
1735,泳,水,8,70,1153626,0.00579961,95.57978339
1736,荒,艸,10,70,1153696,0.00579961,95.58558300
1737,腰,肉,13,70,1153766,0.00579961,95.59138261
1738,鄭,邑,15,70,1153836,0.00579961,95.59718222
1739,蹤,足,18,70,1153906,0.00579961,95.60298183
1740,爐,火,20,70,1153976,0.00579961,95.60878144
1741,競,立,20,70,1154046,0.00579961,95.61458105
1742,勉,力,9,69,1154115,0.00571676,95.62029781
1743,澳,水,16,69,1154184,0.00571676,95.62601457
1744,拾,手,9,69,1154253,0.00571676,95.63173133
1745,髒,骨,23,69,1154322,0.00571676,95.63744809
1746,笨,竹,11,69,1154391,0.00571676,95.64316485
1747,腔,肉,12,69,1154460,0.00571676,95.64888161
1748,稍,禾,12,69,1154529,0.00571676,95.65459837
1749,碳,石,14,69,1154598,0.00571676,95.66031513
1750,嘻,口,15,69,1154667,0.00571676,95.66603189
1751,撲,手,15,69,1154736,0.00571676,95.67174865
1752,遙,ひ,14,69,1154805,0.00571676,95.67746541
1753,澤,水,16,69,1154874,0.00571676,95.68318217
1754,屍,尸,9,69,1154943,0.00571676,95.68889893
1755,牽,牛,11,69,1155012,0.00571676,95.69461569
1756,亦,ぞ,6,68,1155080,0.00563391,95.70024960
1757,咚,口,8,68,1155148,0.00563391,95.70588351
1758,乖,ぜ,8,68,1155216,0.00563391,95.71151742
1759,侯,人,9,68,1155284,0.00563391,95.71715133
1760,貞,貝,9,68,1155352,0.00563391,95.72278524
1761,媒,女,12,68,1155420,0.00563391,95.72841915
1762,譯,言,20,68,1155488,0.00563391,95.73405306
1763,勁,力,9,67,1155555,0.00555106,95.73960412
1764,恰,心,9,67,1155622,0.00555106,95.74515518
1765,皆,白,9,67,1155689,0.00555106,95.75070624
1766,臭,自,10,67,1155756,0.00555106,95.75625730
1767,棋,木,12,67,1155823,0.00555106,95.76180836
1768,敏,の,11,67,1155890,0.00555106,95.76735942
1769,焦,火,12,67,1155957,0.00555106,95.77291048
1770,搜,手,13,67,1156024,0.00555106,95.77846154
1771,款,欠,12,67,1156091,0.00555106,95.78401260
1772,盜,皿,12,67,1156158,0.00555106,95.78956366
1773,嗨,口,13,67,1156225,0.00555106,95.79511472
1774,黎,黍,15,67,1156292,0.00555106,95.80066578
1775,儘,人,16,67,1156359,0.00555106,95.80621684
1776,橘,木,16,67,1156426,0.00555106,95.81176790
1777,穩,禾,19,67,1156493,0.00555106,95.81731896
1778,牢,牛,7,66,1156559,0.00546821,95.82278717
1779,患,心,11,66,1156625,0.00546821,95.82825538
1780,抵,手,8,66,1156691,0.00546821,95.83372359
1781,喪,口,12,66,1156757,0.00546821,95.83919180
1782,桶,木,11,66,1156823,0.00546821,95.84466001
1783,郭,邑,11,66,1156889,0.00546821,95.85012822
1784,胖,肉,9,66,1156955,0.00546821,95.85559643
1785,嗚,口,13,66,1157021,0.00546821,95.86106464
1786,敦,の,12,66,1157087,0.00546821,95.86653285
1787,罰,网,14,66,1157153,0.00546821,95.87200106
1788,漿,水,15,66,1157219,0.00546821,95.87746927
1789,擾,手,18,66,1157285,0.00546821,95.88293748
1790,灘,水,22,66,1157351,0.00546821,95.88840569
1791,齡,齒,20,66,1157417,0.00546821,95.89387390
1792,伍,人,6,65,1157482,0.00538536,95.89925926
1793,丘,一,5,65,1157547,0.00538536,95.90464462
1794,扮,手,7,65,1157612,0.00538536,95.91002998
1795,扶,手,7,65,1157677,0.00538536,95.91541534
1796,淑,水,11,65,1157742,0.00538536,95.92080070
1797,詢,言,13,65,1157807,0.00538536,95.92618606
1798,粽,米,14,65,1157872,0.00538536,95.93157142
1799,嫦,女,14,65,1157937,0.00538536,95.93695678
1800,漆,水,14,65,1158002,0.00538536,95.94234214
1801,撿,手,16,65,1158067,0.00538536,95.94772750
1802,黨,黑,20,65,1158132,0.00538536,95.95311286
1803,譽,言,21,65,1158197,0.00538536,95.95849822
1804,爪,爪,4,64,1158261,0.00530250,95.96380072
1805,呂,口,7,64,1158325,0.00530250,95.96910322
1806,眉,目,9,64,1158389,0.00530250,95.97440572
1807,茂,艸,9,64,1158453,0.00530250,95.97970822
1808,恢,心,9,64,1158517,0.00530250,95.98501072
1809,狸,犬,10,64,1158581,0.00530250,95.99031322
1810,凍,ち,10,64,1158645,0.00530250,95.99561572
1811,純,糸,10,64,1158709,0.00530250,96.00091822
1812,疾,ば,10,64,1158773,0.00530250,96.00622072
1813,瓷,瓦,11,64,1158837,0.00530250,96.01152322
1814,稚,禾,13,64,1158901,0.00530250,96.01682572
1815,蒼,艸,14,64,1158965,0.00530250,96.02212822
1816,韓,韋,17,64,1159029,0.00530250,96.02743072
1817,頻,頁,16,64,1159093,0.00530250,96.03273322
1818,屁,尸,7,63,1159156,0.00521965,96.03795287
1819,坦,土,8,63,1159219,0.00521965,96.04317252
1820,疼,ば,10,63,1159282,0.00521965,96.04839217
1821,脖,肉,11,63,1159345,0.00521965,96.05361182
1822,笛,竹,11,63,1159408,0.00521965,96.05883147
1823,蝕,虫,14,63,1159471,0.00521965,96.06405112
1824,穀,禾,15,63,1159534,0.00521965,96.06927077
1825,凝,ち,16,63,1159597,0.00521965,96.07449042
1826,澆,水,15,63,1159660,0.00521965,96.07971007
1827,蝴,虫,15,63,1159723,0.00521965,96.08492972
1828,錦,金,16,63,1159786,0.00521965,96.09014937
1829,藤,艸,19,63,1159849,0.00521965,96.09536902
1830,旦,日,5,62,1159911,0.00513680,96.10050582
1831,峰,山,10,62,1159973,0.00513680,96.10564262
1832,悅,心,11,62,1160035,0.00513680,96.11077942
1833,陷,阜,11,62,1160097,0.00513680,96.11591622
1834,梨,木,11,62,1160159,0.00513680,96.12105302
1835,瑟,玉,13,62,1160221,0.00513680,96.12618982
1836,厭,厂,14,62,1160283,0.00513680,96.13132662
1837,腐,肉,14,62,1160345,0.00513680,96.13646342
1838,撥,手,15,62,1160407,0.00513680,96.14160022
1839,慕,心,15,62,1160469,0.00513680,96.14673702
1840,療,ば,17,62,1160531,0.00513680,96.15187382
1841,遵,ひ,16,62,1160593,0.00513680,96.15701062
1842,膽,肉,17,62,1160655,0.00513680,96.16214742
1843,串,｜,7,61,1160716,0.00505395,96.16720137
1844,拇,手,8,61,1160777,0.00505395,96.17225532
1845,泊,水,8,61,1160838,0.00505395,96.17730927
1846,捐,手,10,61,1160899,0.00505395,96.18236322
1847,娜,女,10,61,1160960,0.00505395,96.18741717
1848,械,木,11,61,1161021,0.00505395,96.19247112
1849,棚,木,12,61,1161082,0.00505395,96.19752507
1850,碗,石,13,61,1161143,0.00505395,96.20257902
1851,駛,馬,15,61,1161204,0.00505395,96.20763297
1852,螞,虫,16,61,1161265,0.00505395,96.21268692
1853,礎,石,18,61,1161326,0.00505395,96.21774087
1854,籍,竹,20,61,1161387,0.00505395,96.22279482
1855,鬍,髟,19,61,1161448,0.00505395,96.22784877
1856,申,田,5,60,1161508,0.00497110,96.23281987
1857,屈,尸,8,60,1161568,0.00497110,96.23779097
1858,廷,に,7,60,1161628,0.00497110,96.24276207
1859,岳,山,8,60,1161688,0.00497110,96.24773317
1860,盆,皿,9,60,1161748,0.00497110,96.25270427
1861,羿,羽,9,60,1161808,0.00497110,96.25767537
1862,桂,木,10,60,1161868,0.00497110,96.26264647
1863,割,刀,12,60,1161928,0.00497110,96.26761757
1864,韻,音,19,60,1161988,0.00497110,96.27258867
1865,欲,欠,11,60,1162048,0.00497110,96.27755977
1866,愚,心,13,60,1162108,0.00497110,96.28253087
1867,軻,車,12,60,1162168,0.00497110,96.28750197
1868,溜,水,13,60,1162228,0.00497110,96.29247307
1869,傾,人,13,60,1162288,0.00497110,96.29744417
1870,琳,玉,12,60,1162348,0.00497110,96.30241527
1871,徹,彳,14,60,1162408,0.00497110,96.30738637
1872,董,艸,13,60,1162468,0.00497110,96.31235747
1873,輛,車,15,60,1162528,0.00497110,96.31732857
1874,糟,米,17,60,1162588,0.00497110,96.32229967
1875,喂,口,12,60,1162648,0.00497110,96.32727077
1876,予,そ,4,59,1162707,0.00488825,96.33215902
1877,摘,手,14,59,1162766,0.00488825,96.33704727
1878,狂,犬,7,59,1162825,0.00488825,96.34193552
1879,范,艸,9,59,1162884,0.00488825,96.34682377
1880,盼,目,9,59,1162943,0.00488825,96.35171202
1881,役,彳,7,59,1163002,0.00488825,96.35660027
1882,翰,羽,16,59,1163061,0.00488825,96.36148852
1883,蕉,艸,16,59,1163120,0.00488825,96.36637677
1884,鍵,金,17,59,1163179,0.00488825,96.37126502
1885,襲,衣,22,59,1163238,0.00488825,96.37615327
1886,礙,石,19,59,1163297,0.00488825,96.38104152
1887,宏,で,7,58,1163355,0.00480539,96.38584691
1888,箏,竹,14,58,1163413,0.00480539,96.39065230
1889,狠,犬,9,58,1163471,0.00480539,96.39545769
1890,添,水,11,58,1163529,0.00480539,96.40026308
1891,喬,口,12,58,1163587,0.00480539,96.40506847
1892,蜥,虫,14,58,1163645,0.00480539,96.40987386
1893,苗,艸,9,58,1163703,0.00480539,96.41467925
1894,瘦,ば,15,58,1163761,0.00480539,96.41948464
1895,踢,足,15,58,1163819,0.00480539,96.42429003
1896,懸,心,20,58,1163877,0.00480539,96.42909542
1897,匆,ぢ,5,57,1163934,0.00472254,96.43381796
1898,伐,人,6,57,1163991,0.00472254,96.43854050
1899,批,手,7,57,1164048,0.00472254,96.44326304
1900,夥,夕,14,57,1164105,0.00472254,96.44798558
1901,祈,示,9,57,1164162,0.00472254,96.45270812
1902,茄,艸,9,57,1164219,0.00472254,96.45743066
1903,秘,禾,10,57,1164276,0.00472254,96.46215320
1904,帳,巾,11,57,1164333,0.00472254,96.46687574
1905,采,釆,8,57,1164390,0.00472254,96.47159828
1906,潛,水,15,57,1164447,0.00472254,96.47632082
1907,嶼,山,17,57,1164504,0.00472254,96.48104336
1908,簧,竹,18,57,1164561,0.00472254,96.48576590
1909,鍋,金,17,57,1164618,0.00472254,96.49048844
1910,繡,糸,18,57,1164675,0.00472254,96.49521098
1911,贊,貝,19,57,1164732,0.00472254,96.49993352
1912,慰,心,15,56,1164788,0.00463969,96.50457321
1913,憲,心,16,56,1164844,0.00463969,96.50921290
1914,邦,邑,7,56,1164900,0.00463969,96.51385259
1915,駕,馬,15,56,1164956,0.00463969,96.51849228
1916,哀,口,9,56,1165012,0.00463969,96.52313197
1917,謂,言,16,56,1165068,0.00463969,96.52777166
1918,梁,木,11,56,1165124,0.00463969,96.53241135
1919,窩,穴,14,56,1165180,0.00463969,96.53705104
1920,漠,水,14,56,1165236,0.00463969,96.54169073
1921,醉,酉,15,56,1165292,0.00463969,96.54633042
1922,膜,肉,15,56,1165348,0.00463969,96.55097011
1923,犬,犬,4,56,1165404,0.00463969,96.55560980
1924,抹,手,8,56,1165460,0.00463969,96.56024949
1925,桿,木,11,56,1165516,0.00463969,96.56488918
1926,趁,走,12,56,1165572,0.00463969,96.56952887
1927,帆,巾,6,55,1165627,0.00455684,96.57408571
1928,弗,弓,5,55,1165682,0.00455684,96.57864255
1929,圾,土,7,55,1165737,0.00455684,96.58319939
1930,垃,土,8,55,1165792,0.00455684,96.58775623
1931,炸,火,9,55,1165847,0.00455684,96.59231307
1932,泌,水,8,55,1165902,0.00455684,96.59686991
1933,祕,示,10,55,1165957,0.00455684,96.60142675
1934,啄,口,11,55,1166012,0.00455684,96.60598359
1935,惱,心,12,55,1166067,0.00455684,96.61054043
1936,瞪,目,17,55,1166122,0.00455684,96.61509727
1937,滔,水,13,55,1166177,0.00455684,96.61965411
1938,碧,石,14,55,1166232,0.00455684,96.62421095
1939,誌,言,14,55,1166287,0.00455684,96.62876779
1940,闆,門,17,55,1166342,0.00455684,96.63332463
1941,猶,犬,12,55,1166397,0.00455684,96.63788147
1942,糧,米,18,55,1166452,0.00455684,96.64243831
1943,脊,肉,10,54,1166506,0.00447399,96.64691230
1944,唯,口,11,54,1166560,0.00447399,96.65138629
1945,爽,爻,11,54,1166614,0.00447399,96.65586028
1946,控,手,11,54,1166668,0.00447399,96.66033427
1947,訝,言,11,54,1166722,0.00447399,96.66480826
1948,辯,辛,21,54,1166776,0.00447399,96.66928225
1949,慘,心,14,54,1166830,0.00447399,96.67375624
1950,銳,金,15,54,1166884,0.00447399,96.67823023
1951,劑,刀,16,54,1166938,0.00447399,96.68270422
1952,謙,言,17,54,1166992,0.00447399,96.68717821
1953,鴉,鳥,15,54,1167046,0.00447399,96.69165220
1954,鱷,魚,27,54,1167100,0.00447399,96.69612619
1955,召,口,5,53,1167153,0.00439114,96.70051733
1956,干,干,3,53,1167206,0.00439114,96.70490847
1957,弓,弓,3,53,1167259,0.00439114,96.70929961
1958,盈,皿,9,53,1167312,0.00439114,96.71369075
1959,疲,ば,10,53,1167365,0.00439114,96.71808189
1960,執,土,11,53,1167418,0.00439114,96.72247303
1961,蛛,虫,12,53,1167471,0.00439114,96.72686417
1962,筷,竹,13,53,1167524,0.00439114,96.73125531
1963,諒,言,15,53,1167577,0.00439114,96.73564645
1964,芒,艸,7,52,1167629,0.00430828,96.73995473
1965,尿,尸,7,52,1167681,0.00430828,96.74426301
1966,牲,牛,9,52,1167733,0.00430828,96.74857129
1967,茲,艸,10,52,1167785,0.00430828,96.75287957
1968,莎,艸,11,52,1167837,0.00430828,96.75718785
1969,愁,心,13,52,1167889,0.00430828,96.76149613
1970,跨,足,13,52,1167941,0.00430828,96.76580441
1971,歉,欠,14,52,1167993,0.00430828,96.77011269
1972,睜,目,13,52,1168045,0.00430828,96.77442097
1973,賺,貝,17,52,1168097,0.00430828,96.77872925
1974,龐,な,19,52,1168149,0.00430828,96.78303753
1975,罐,缶,24,52,1168201,0.00430828,96.78734581
1976,仇,人,4,51,1168252,0.00422543,96.79157124
1977,巫,工,7,51,1168303,0.00422543,96.79579667
1978,戒,戈,7,51,1168354,0.00422543,96.80002210
1979,返,ひ,8,51,1168405,0.00422543,96.80424753
1980,姨,女,9,51,1168456,0.00422543,96.80847296
1981,臥,臣,8,51,1168507,0.00422543,96.81269839
1982,眠,目,10,51,1168558,0.00422543,96.81692382
1983,曼,又,11,51,1168609,0.00422543,96.82114925
1984,購,貝,17,51,1168660,0.00422543,96.82537468
1985,悉,心,11,51,1168711,0.00422543,96.82960011
1986,欺,欠,12,51,1168762,0.00422543,96.83382554
1987,鉤,金,13,51,1168813,0.00422543,96.83805097
1988,澎,水,15,51,1168864,0.00422543,96.84227640
1989,痕,ば,11,51,1168915,0.00422543,96.84650183
1990,蹈,足,17,51,1168966,0.00422543,96.85072726
1991,薩,艸,18,51,1169017,0.00422543,96.85495269
1992,撐,手,15,51,1169068,0.00422543,96.85917812
1993,巾,巾,3,50,1169118,0.00414258,96.86332070
1994,划,刀,6,50,1169168,0.00414258,96.86746328
1995,奴,女,5,50,1169218,0.00414258,96.87160586
1996,玲,玉,9,50,1169268,0.00414258,96.87574844
1997,迫,ひ,9,50,1169318,0.00414258,96.87989102
1998,茫,艸,10,50,1169368,0.00414258,96.88403360
1999,堪,土,12,50,1169418,0.00414258,96.88817618
2000,塘,土,13,50,1169468,0.00414258,96.89231876
2001,溝,水,13,50,1169518,0.00414258,96.89646134
2002,裁,衣,12,50,1169568,0.00414258,96.90060392
2003,頑,頁,13,50,1169618,0.00414258,96.90474650
2004,暢,日,14,50,1169668,0.00414258,96.90888908
2005,哎,口,9,50,1169718,0.00414258,96.91303166
2006,赫,赤,14,50,1169768,0.00414258,96.91717424
2007,遮,ひ,15,50,1169818,0.00414258,96.92131682
2008,糊,米,15,50,1169868,0.00414258,96.92545940
2009,銘,金,14,50,1169918,0.00414258,96.92960198
2010,魏,鬼,18,50,1169968,0.00414258,96.93374456
2011,吊,口,6,49,1170017,0.00405973,96.93780429
2012,凸,凵,5,49,1170066,0.00405973,96.94186402
2013,咐,口,8,49,1170115,0.00405973,96.94592375
2014,肢,肉,8,49,1170164,0.00405973,96.94998348
2015,宴,で,10,49,1170213,0.00405973,96.95404321
2016,唷,口,10,49,1170262,0.00405973,96.95810294
2017,爹,父,10,49,1170311,0.00405973,96.96216267
2018,猿,犬,13,49,1170360,0.00405973,96.96622240
2019,綁,糸,13,49,1170409,0.00405973,96.97028213
2020,蒐,艸,14,49,1170458,0.00405973,96.97434186
2021,暫,日,15,49,1170507,0.00405973,96.97840159
2022,颱,風,14,49,1170556,0.00405973,96.98246132
2023,澱,水,16,49,1170605,0.00405973,96.98652105
2024,馨,香,20,49,1170654,0.00405973,96.99058078
2025,斧,斤,8,48,1170702,0.00397688,96.99455766
2026,抖,手,7,48,1170750,0.00397688,96.99853454
2027,怡,心,8,48,1170798,0.00397688,97.00251142
2028,赤,赤,7,48,1170846,0.00397688,97.00648830
2029,逢,ひ,11,48,1170894,0.00397688,97.01046518
2030,悠,心,11,48,1170942,0.00397688,97.01444206
2031,跌,足,12,48,1170990,0.00397688,97.01841894
2032,湧,水,12,48,1171038,0.00397688,97.02239582
2033,螢,虫,16,48,1171086,0.00397688,97.02637270
2034,跪,足,13,48,1171134,0.00397688,97.03034958
2035,踐,足,15,48,1171182,0.00397688,97.03432646
2036,盧,皿,16,48,1171230,0.00397688,97.03830334
2037,璧,玉,18,48,1171278,0.00397688,97.04228022
2038,嘩,口,15,48,1171326,0.00397688,97.04625710
2039,鎖,金,18,48,1171374,0.00397688,97.05023398
2040,蠶,虫,24,48,1171422,0.00397688,97.05421086
2041,繫,糸,19,48,1171470,0.00397688,97.05818774
2042,旨,日,6,47,1171517,0.00389403,97.06208177
2043,凶,凵,4,47,1171564,0.00389403,97.06597580
2044,佔,人,7,47,1171611,0.00389403,97.06986983
2045,逆,ひ,10,47,1171658,0.00389403,97.07376386
2046,拓,手,8,47,1171705,0.00389403,97.07765789
2047,怨,心,9,47,1171752,0.00389403,97.08155192
2048,柯,木,9,47,1171799,0.00389403,97.08544595
2049,挺,手,10,47,1171846,0.00389403,97.08933998
2050,佑,人,7,47,1171893,0.00389403,97.09323401
2051,寂,で,11,47,1171940,0.00389403,97.09712804
2052,淋,水,11,47,1171987,0.00389403,97.10102207
2053,逛,ひ,11,47,1172034,0.00389403,97.10491610
2054,菲,艸,12,47,1172081,0.00389403,97.10881013
2055,截,戈,14,47,1172128,0.00389403,97.11270416
2056,誇,言,13,47,1172175,0.00389403,97.11659819
2057,轟,車,21,47,1172222,0.00389403,97.12049222
2058,瑜,玉,13,47,1172269,0.00389403,97.12438625
2059,墳,土,15,47,1172316,0.00389403,97.12828028
2060,櫃,木,18,47,1172363,0.00389403,97.13217431
2061,籌,竹,20,47,1172410,0.00389403,97.13606834
2062,獄,犬,14,47,1172457,0.00389403,97.13996237
2063,鯊,魚,18,47,1172504,0.00389403,97.14385640
2064,顎,頁,18,47,1172551,0.00389403,97.14775043
2065,耍,而,9,46,1172597,0.00381117,97.15156160
2066,砂,石,9,46,1172643,0.00381117,97.15537277
2067,悔,心,10,46,1172689,0.00381117,97.15918394
2068,喃,口,12,46,1172735,0.00381117,97.16299511
2069,纏,糸,21,46,1172781,0.00381117,97.16680628
2070,婿,女,12,46,1172827,0.00381117,97.17061745
2071,憂,心,15,46,1172873,0.00381117,97.17442862
2072,艱,艮,17,46,1172919,0.00381117,97.17823979
2073,鍊,金,17,46,1172965,0.00381117,97.18205096
2074,賜,貝,15,46,1173011,0.00381117,97.18586213
2075,顱,頁,25,46,1173057,0.00381117,97.18967330
2076,兇,儿,6,45,1173102,0.00372832,97.19340162
2077,宅,で,6,45,1173147,0.00372832,97.19712994
2078,押,手,8,45,1173192,0.00372832,97.20085826
2079,泛,水,8,45,1173237,0.00372832,97.20458658
2080,挨,手,10,45,1173282,0.00372832,97.20831490
2081,酷,酉,14,45,1173327,0.00372832,97.21204322
2082,兼,八,10,45,1173372,0.00372832,97.21577154
2083,豎,豆,15,45,1173417,0.00372832,97.21949986
2084,莓,艸,11,45,1173462,0.00372832,97.22322818
2085,審,で,15,45,1173507,0.00372832,97.22695650
2086,萄,艸,12,45,1173552,0.00372832,97.23068482
2087,嘰,口,15,45,1173597,0.00372832,97.23441314
2088,賊,貝,13,45,1173642,0.00372832,97.23814146
2089,鴿,鳥,17,45,1173687,0.00372832,97.24186978
2090,孵,子,14,45,1173732,0.00372832,97.24559810
2091,儲,人,17,45,1173777,0.00372832,97.24932642
2092,羨,羊,13,45,1173822,0.00372832,97.25305474
2093,惰,心,12,45,1173867,0.00372832,97.25678306
2094,督,目,13,45,1173912,0.00372832,97.26051138
2095,葡,艸,13,45,1173957,0.00372832,97.26423970
2096,葛,艸,13,45,1174002,0.00372832,97.26796802
2097,婷,女,12,45,1174047,0.00372832,97.27169634
2098,玄,玄,5,44,1174091,0.00364547,97.27534181
2099,札,木,5,44,1174135,0.00364547,97.27898728
2100,扯,手,7,44,1174179,0.00364547,97.28263275
2101,帕,巾,8,44,1174223,0.00364547,97.28627822
2102,貪,貝,11,44,1174267,0.00364547,97.28992369
2103,豚,豕,11,44,1174311,0.00364547,97.29356916
2104,棧,木,12,44,1174355,0.00364547,97.29721463
2105,註,言,12,44,1174399,0.00364547,97.30086010
2106,腺,肉,13,44,1174443,0.00364547,97.30450557
2107,邁,ひ,17,44,1174487,0.00364547,97.30815104
2108,灑,水,22,44,1174531,0.00364547,97.31179651
2109,叉,又,3,43,1174574,0.00356262,97.31535913
2110,企,人,6,43,1174617,0.00356262,97.31892175
2111,叭,口,5,43,1174660,0.00356262,97.32248437
2112,卷,つ,8,43,1174703,0.00356262,97.32604699
2113,卓,十,8,43,1174746,0.00356262,97.32960961
2114,玫,玉,8,43,1174789,0.00356262,97.33317223
2115,烤,火,10,43,1174832,0.00356262,97.33673485
2116,匙,匕,11,43,1174875,0.00356262,97.34029747
2117,鋪,金,15,43,1174918,0.00356262,97.34386009
2118,盪,皿,17,43,1174961,0.00356262,97.34742271
2119,措,手,11,43,1175004,0.00356262,97.35098533
2120,渴,水,12,43,1175047,0.00356262,97.35454795
2121,嫩,女,14,43,1175090,0.00356262,97.35811057
2122,株,木,10,43,1175133,0.00356262,97.36167319
2123,廉,な,13,43,1175176,0.00356262,97.36523581
2124,乏,ぜ,5,42,1175218,0.00347977,97.36871558
2125,舟,舟,6,42,1175260,0.00347977,97.37219535
2126,汪,水,7,42,1175302,0.00347977,97.37567512
2127,吩,口,7,42,1175344,0.00347977,97.37915489
2128,韋,韋,9,42,1175386,0.00347977,97.38263466
2129,紂,糸,9,42,1175428,0.00347977,97.38611443
2130,遜,ひ,14,42,1175470,0.00347977,97.38959420
2131,宵,で,10,42,1175512,0.00347977,97.39307397
2132,釣,金,11,42,1175554,0.00347977,97.39655374
2133,喚,口,12,42,1175596,0.00347977,97.40003351
2134,蜘,虫,14,42,1175638,0.00347977,97.40351328
2135,哼,口,10,42,1175680,0.00347977,97.40699305
2136,擬,手,17,42,1175722,0.00347977,97.41047282
2137,醜,酉,17,42,1175764,0.00347977,97.41395259
2138,驕,馬,22,42,1175806,0.00347977,97.41743236
2139,藻,艸,20,42,1175848,0.00347977,97.42091213
2140,囊,口,22,42,1175890,0.00347977,97.42439190
2141,昌,日,8,41,1175931,0.00339692,97.42778882
2142,畜,田,10,41,1175972,0.00339692,97.43118574
2143,泣,水,8,41,1176013,0.00339692,97.43458266
2144,軌,車,9,41,1176054,0.00339692,97.43797958
2145,芭,艸,8,41,1176095,0.00339692,97.44137650
2146,邱,邑,8,41,1176136,0.00339692,97.44477342
2147,妨,女,7,41,1176177,0.00339692,97.44817034
2148,傍,人,12,41,1176218,0.00339692,97.45156726
2149,閔,門,12,41,1176259,0.00339692,97.45496418
2150,椎,木,12,41,1176300,0.00339692,97.45836110
2151,瑰,玉,14,41,1176341,0.00339692,97.46175802
2152,擅,手,16,41,1176382,0.00339692,97.46515494
2153,遞,ひ,14,41,1176423,0.00339692,97.46855186
2154,寵,で,19,41,1176464,0.00339692,97.47194878
2155,憤,心,15,41,1176505,0.00339692,97.47534570
2156,嬰,女,17,41,1176546,0.00339692,97.47874262
2157,謀,言,16,41,1176587,0.00339692,97.48213954
2158,嚷,口,20,41,1176628,0.00339692,97.48553646
2159,罷,网,15,41,1176669,0.00339692,97.48893338
2160,驅,馬,21,41,1176710,0.00339692,97.49233030
2161,鑿,金,28,41,1176751,0.00339692,97.49572722
2162,掰,手,12,41,1176792,0.00339692,97.49912414
2163,扣,手,6,40,1176832,0.00331406,97.50243820
2164,仗,人,5,40,1176872,0.00331406,97.50575226
2165,征,彳,8,40,1176912,0.00331406,97.50906632
2166,宿,で,11,40,1176952,0.00331406,97.51238038
2167,牡,牛,7,40,1176992,0.00331406,97.51569444
2168,昭,日,9,40,1177032,0.00331406,97.51900850
2169,浩,水,10,40,1177072,0.00331406,97.52232256
2170,泰,水,10,40,1177112,0.00331406,97.52563662
2171,枚,木,8,40,1177152,0.00331406,97.52895068
2172,滋,水,12,40,1177192,0.00331406,97.53226474
2173,漲,水,14,40,1177232,0.00331406,97.53557880
2174,漏,水,14,40,1177272,0.00331406,97.53889286
2175,噹,口,16,40,1177312,0.00331406,97.54220692
2176,嬌,女,15,40,1177352,0.00331406,97.54552098
2177,魂,鬼,14,40,1177392,0.00331406,97.54883504
2178,瞭,目,17,40,1177432,0.00331406,97.55214910
2179,褐,衣,15,40,1177472,0.00331406,97.55546316
2180,遼,ひ,16,40,1177512,0.00331406,97.55877722
2181,霜,雨,17,40,1177552,0.00331406,97.56209128
2182,嶺,山,17,40,1177592,0.00331406,97.56540534
2183,隙,阜,14,40,1177632,0.00331406,97.56871940
2184,闖,門,18,40,1177672,0.00331406,97.57203346
2185,藺,艸,20,40,1177712,0.00331406,97.57534752
2186,枕,木,8,39,1177751,0.00323121,97.57857873
2187,忌,心,7,39,1177790,0.00323121,97.58180994
2188,浴,水,10,39,1177829,0.00323121,97.58504115
2189,紗,糸,10,39,1177868,0.00323121,97.58827236
2190,裙,衣,13,39,1177907,0.00323121,97.59150357
2191,砝,石,10,39,1177946,0.00323121,97.59473478
2192,傢,人,12,39,1177985,0.00323121,97.59796599
2193,慎,心,13,39,1178024,0.00323121,97.60119720
2194,綜,糸,14,39,1178063,0.00323121,97.60442841
2195,絃,糸,11,39,1178102,0.00323121,97.60765962
2196,碌,石,13,39,1178141,0.00323121,97.61089083
2197,摔,手,14,39,1178180,0.00323121,97.61412204
2198,榜,木,14,39,1178219,0.00323121,97.61735325
2199,潤,水,15,39,1178258,0.00323121,97.62058446
2200,遣,ひ,14,39,1178297,0.00323121,97.62381567
2201,濫,水,17,39,1178336,0.00323121,97.62704688
2202,簽,竹,19,39,1178375,0.00323121,97.63027809
2203,驟,馬,24,39,1178414,0.00323121,97.63350930
2204,臘,肉,19,39,1178453,0.00323121,97.63674051
2205,纖,糸,23,39,1178492,0.00323121,97.63997172
2206,歹,歹,4,38,1178530,0.00314836,97.64312008
2207,趴,足,9,38,1178568,0.00314836,97.64626844
2208,豹,豸,10,38,1178606,0.00314836,97.64941680
2209,娶,女,11,38,1178644,0.00314836,97.65256516
2210,飢,食,10,38,1178682,0.00314836,97.65571352
2211,陵,阜,11,38,1178720,0.00314836,97.65886188
2212,掘,手,11,38,1178758,0.00314836,97.66201024
2213,瘋,ば,14,38,1178796,0.00314836,97.66515860
2214,禍,示,14,38,1178834,0.00314836,97.66830696
2215,皺,皮,15,38,1178872,0.00314836,97.67145532
2216,燥,火,17,38,1178910,0.00314836,97.67460368
2217,燦,火,17,38,1178948,0.00314836,97.67775204
2218,贏,貝,20,38,1178986,0.00314836,97.68090040
2219,扔,手,5,37,1179023,0.00306551,97.68396591
2220,怖,心,8,37,1179060,0.00306551,97.68703142
2221,胚,肉,9,37,1179097,0.00306551,97.69009693
2222,涉,水,10,37,1179134,0.00306551,97.69316244
2223,紐,糸,10,37,1179171,0.00306551,97.69622795
2224,晏,日,10,37,1179208,0.00306551,97.69929346
2225,崖,山,11,37,1179245,0.00306551,97.70235897
2226,捷,手,11,37,1179282,0.00306551,97.70542448
2227,禱,示,19,37,1179319,0.00306551,97.70848999
2228,壹,士,12,37,1179356,0.00306551,97.71155550
2229,豔,豆,28,37,1179393,0.00306551,97.71462101
2230,瑚,玉,13,37,1179430,0.00306551,97.71768652
2231,潭,水,15,37,1179467,0.00306551,97.72075203
2232,頗,頁,14,37,1179504,0.00306551,97.72381754
2233,稿,禾,15,37,1179541,0.00306551,97.72688305
2234,嬸,女,18,37,1179578,0.00306551,97.72994856
2235,艘,舟,16,37,1179615,0.00306551,97.73301407
2236,鑑,金,22,37,1179652,0.00306551,97.73607958
2237,鱗,魚,23,37,1179689,0.00306551,97.73914509
2238,寓,で,12,37,1179726,0.00306551,97.74221060
2239,綺,糸,14,37,1179763,0.00306551,97.74527611
2240,匈,ぢ,6,36,1179799,0.00298266,97.74825877
2241,岡,山,8,36,1179835,0.00298266,97.75124143
2242,吱,口,7,36,1179871,0.00298266,97.75422409
2243,弧,弓,8,36,1179907,0.00298266,97.75720675
2244,辰,辰,7,36,1179943,0.00298266,97.76018941
2245,彷,彳,7,36,1179979,0.00298266,97.76317207
2246,氛,气,8,36,1180015,0.00298266,97.76615473
2247,沸,水,8,36,1180051,0.00298266,97.76913739
2248,歪,止,9,36,1180087,0.00298266,97.77212005
2249,巷,己,9,36,1180123,0.00298266,97.77510271
2250,姪,女,9,36,1180159,0.00298266,97.77808537
2251,樸,木,16,36,1180195,0.00298266,97.78106803
2252,袁,衣,10,36,1180231,0.00298266,97.78405069
2253,螃,虫,16,36,1180267,0.00298266,97.78703335
2254,晒,日,10,36,1180303,0.00298266,97.79001601
2255,犧,牛,20,36,1180339,0.00298266,97.79299867
2256,喇,口,12,36,1180375,0.00298266,97.79598133
2257,綻,糸,14,36,1180411,0.00298266,97.79896399
2258,廖,な,14,36,1180447,0.00298266,97.80194665
2259,墊,土,14,36,1180483,0.00298266,97.80492931
2260,銷,金,15,36,1180519,0.00298266,97.80791197
2261,鄧,邑,15,36,1180555,0.00298266,97.81089463
2262,准,ち,10,36,1180591,0.00298266,97.81387729
2263,啼,口,12,36,1180627,0.00298266,97.81685995
2264,揭,手,12,36,1180663,0.00298266,97.81984261
2265,乞,乙,3,35,1180698,0.00289981,97.82274242
2266,亨,ぞ,7,35,1180733,0.00289981,97.82564223
2267,拋,手,8,35,1180768,0.00289981,97.82854204
2268,芝,艸,8,35,1180803,0.00289981,97.83144185
2269,陌,阜,9,35,1180838,0.00289981,97.83434166
2270,偕,人,11,35,1180873,0.00289981,97.83724147
2271,脆,肉,10,35,1180908,0.00289981,97.84014128
2272,梳,木,10,35,1180943,0.00289981,97.84304109
2273,宰,で,10,35,1180978,0.00289981,97.84594090
2274,症,ば,10,35,1181013,0.00289981,97.84884071
2275,騫,馬,20,35,1181048,0.00289981,97.85174052
2276,淘,水,11,35,1181083,0.00289981,97.85464033
2277,蘊,艸,20,35,1181118,0.00289981,97.85754014
2278,捧,手,11,35,1181153,0.00289981,97.86043995
2279,嫌,女,13,35,1181188,0.00289981,97.86333976
2280,飼,食,13,35,1181223,0.00289981,97.86623957
2281,裕,衣,13,35,1181258,0.00289981,97.86913938
2282,踩,足,15,35,1181293,0.00289981,97.87203919
2283,墾,土,16,35,1181328,0.00289981,97.87493900
2284,鍾,金,17,35,1181363,0.00289981,97.87783881
2285,謹,言,18,35,1181398,0.00289981,97.88073862
2286,涵,水,11,35,1181433,0.00289981,97.88363843
2287,搞,手,13,35,1181468,0.00289981,97.88653824
2288,妥,女,7,34,1181502,0.00281696,97.88935520
2289,昇,日,8,34,1181536,0.00281696,97.89217216
2290,沼,水,8,34,1181570,0.00281696,97.89498912
2291,俠,人,9,34,1181604,0.00281696,97.89780608
2292,彥,ね,9,34,1181638,0.00281696,97.90062304
2293,耘,耒,10,34,1181672,0.00281696,97.90344000
2294,唸,口,11,34,1181706,0.00281696,97.90625696
2295,秤,禾,10,34,1181740,0.00281696,97.90907392
2296,廊,な,12,34,1181774,0.00281696,97.91189088
2297,喉,口,12,34,1181808,0.00281696,97.91470784
2298,愧,心,13,34,1181842,0.00281696,97.91752480
2299,閣,門,14,34,1181876,0.00281696,97.92034176
2300,蔗,艸,15,34,1181910,0.00281696,97.92315872
2301,貳,貝,12,34,1181944,0.00281696,97.92597568
2302,賭,貝,15,34,1181978,0.00281696,97.92879264
2303,僕,人,14,34,1182012,0.00281696,97.93160960
2304,蔬,艸,15,34,1182046,0.00281696,97.93442656
2305,禽,禸,13,34,1182080,0.00281696,97.93724352
2306,濕,水,17,34,1182114,0.00281696,97.94006048
2307,熄,火,14,34,1182148,0.00281696,97.94287744
2308,薪,艸,17,34,1182182,0.00281696,97.94569440
2309,誼,言,15,34,1182216,0.00281696,97.94851136
2310,鑄,金,22,34,1182250,0.00281696,97.95132832
2311,溉,水,12,34,1182284,0.00281696,97.95414528
2312,熔,火,14,34,1182318,0.00281696,97.95696224
2313,馳,馬,13,34,1182352,0.00281696,97.95977920
2314,撫,手,15,34,1182386,0.00281696,97.96259616
2315,蔣,艸,15,34,1182420,0.00281696,97.96541312
2316,嫂,女,13,34,1182454,0.00281696,97.96823008
2317,仲,人,6,33,1182487,0.00273410,97.97096418
2318,彿,彳,8,33,1182520,0.00273410,97.97369828
2319,奈,大,8,33,1182553,0.00273410,97.97643238
2320,併,人,8,33,1182586,0.00273410,97.97916648
2321,披,手,8,33,1182619,0.00273410,97.98190058
2322,吼,口,7,33,1182652,0.00273410,97.98463468
2323,蜴,虫,14,33,1182685,0.00273410,97.98736878
2324,亭,ぞ,9,33,1182718,0.00273410,97.99010288
2325,擋,手,16,33,1182751,0.00273410,97.99283698
2326,衰,衣,10,33,1182784,0.00273410,97.99557108
2327,螂,虫,15,33,1182817,0.00273410,97.99830518
2328,慨,心,12,33,1182850,0.00273410,98.00103928
2329,窯,穴,15,33,1182883,0.00273410,98.00377338
2330,覓,見,11,33,1182916,0.00273410,98.00650748
2331,噢,口,16,33,1182949,0.00273410,98.00924158
2332,葬,艸,13,33,1182982,0.00273410,98.01197568
2333,禧,示,17,33,1183015,0.00273410,98.01470978
2334,兢,儿,14,33,1183048,0.00273410,98.01744388
2335,虧,虍,17,33,1183081,0.00273410,98.02017798
2336,浸,水,10,33,1183114,0.00273410,98.02291208
2337,署,网,13,33,1183147,0.00273410,98.02564618
2338,嘍,口,14,33,1183180,0.00273410,98.02838028
2339,紡,糸,10,33,1183213,0.00273410,98.03111438
2340,梭,木,11,33,1183246,0.00273410,98.03384848
2341,譬,言,20,33,1183279,0.00273410,98.03658258
2342,軀,身,18,33,1183312,0.00273410,98.03931668
2343,拆,手,8,32,1183344,0.00265125,98.04196793
2344,吻,口,7,32,1183376,0.00265125,98.04461918
2345,畏,田,9,32,1183408,0.00265125,98.04727043
2346,炒,火,8,32,1183440,0.00265125,98.04992168
2347,趟,走,15,32,1183472,0.00265125,98.05257293
2348,挫,手,10,32,1183504,0.00265125,98.05522418
2349,劈,刀,15,32,1183536,0.00265125,98.05787543
2350,卿,つ,10,32,1183568,0.00265125,98.06052668
2351,緻,糸,15,32,1183600,0.00265125,98.06317793
2352,逝,ひ,11,32,1183632,0.00265125,98.06582918
2353,聳,耳,17,32,1183664,0.00265125,98.06848043
2354,掩,手,11,32,1183696,0.00265125,98.07113168
2355,鋸,金,16,32,1183728,0.00265125,98.07378293
2356,援,手,12,32,1183760,0.00265125,98.07643418
2357,儡,人,17,32,1183792,0.00265125,98.07908543
2358,罩,网,13,32,1183824,0.00265125,98.08173668
2359,礫,石,20,32,1183856,0.00265125,98.08438793
2360,媚,女,12,32,1183888,0.00265125,98.08703918
2361,閎,門,12,32,1183920,0.00265125,98.08969043
2362,葫,艸,13,32,1183952,0.00265125,98.09234168
2363,栽,木,10,32,1183984,0.00265125,98.09499293
2364,傀,人,12,32,1184016,0.00265125,98.09764418
2365,攜,手,21,32,1184048,0.00265125,98.10029543
2366,轎,車,19,32,1184080,0.00265125,98.10294668
2367,刑,刀,6,31,1184111,0.00256840,98.10551508
2368,叩,口,5,31,1184142,0.00256840,98.10808348
2369,昂,日,8,31,1184173,0.00256840,98.11065188
2370,咒,口,8,31,1184204,0.00256840,98.11322028
2371,嘲,口,15,31,1184235,0.00256840,98.11578868
2372,拒,手,8,31,1184266,0.00256840,98.11835708
2373,蝸,虫,15,31,1184297,0.00256840,98.12092548
2374,眨,目,10,31,1184328,0.00256840,98.12349388
2375,磚,石,16,31,1184359,0.00256840,98.12606228
2376,惑,心,12,31,1184390,0.00256840,98.12863068
2377,瀑,水,18,31,1184421,0.00256840,98.13119908
2378,毯,毛,12,31,1184452,0.00256840,98.13376748
2379,薇,艸,17,31,1184483,0.00256840,98.13633588
2380,緒,糸,14,31,1184514,0.00256840,98.13890428
2381,餵,食,17,31,1184545,0.00256840,98.14147268
2382,撈,手,15,31,1184576,0.00256840,98.14404108
2383,鹼,鹵,24,31,1184607,0.00256840,98.14660948
2384,晉,日,10,31,1184638,0.00256840,98.14917788
2385,滲,水,14,31,1184669,0.00256840,98.15174628
2386,撕,手,15,31,1184700,0.00256840,98.15431468
2387,盾,目,9,31,1184731,0.00256840,98.15688308
2388,絮,糸,12,31,1184762,0.00256840,98.15945148
2389,懼,心,21,31,1184793,0.00256840,98.16201988
2390,霸,雨,21,31,1184824,0.00256840,98.16458828
2391,瓣,瓜,19,31,1184855,0.00256840,98.16715668
2392,鑼,金,27,31,1184886,0.00256840,98.16972508
2393,污,水,6,30,1184916,0.00248555,98.17221063
2394,迅,ひ,7,30,1184946,0.00248555,98.17469618
2395,脾,肉,12,30,1184976,0.00248555,98.17718173
2396,診,言,12,30,1185006,0.00248555,98.17966728
2397,皂,白,7,30,1185036,0.00248555,98.18215283
2398,煉,火,13,30,1185066,0.00248555,98.18463838
2399,郁,邑,9,30,1185096,0.00248555,98.18712393
2400,舜,舛,12,30,1185126,0.00248555,98.18960948
2401,柄,木,9,30,1185156,0.00248555,98.19209503
2402,棟,木,12,30,1185186,0.00248555,98.19458058
2403,凌,ち,10,30,1185216,0.00248555,98.19706613
2404,雯,雨,12,30,1185246,0.00248555,98.19955168
2405,彗,ぬ,11,30,1185276,0.00248555,98.20203723
2406,鈔,金,12,30,1185306,0.00248555,98.20452278
2407,吟,口,7,30,1185336,0.00248555,98.20700833
2408,鼎,鼎,13,30,1185366,0.00248555,98.20949388
2409,津,水,9,30,1185396,0.00248555,98.21197943
2410,喘,口,12,30,1185426,0.00248555,98.21446498
2411,脹,肉,12,30,1185456,0.00248555,98.21695053
2412,冶,ち,7,30,1185486,0.00248555,98.21943608
2413,勃,力,9,30,1185516,0.00248555,98.22192163
2414,碑,石,13,30,1185546,0.00248555,98.22440718
2415,澄,水,15,30,1185576,0.00248555,98.22689273
2416,儒,人,16,30,1185606,0.00248555,98.22937828
2417,緯,糸,15,30,1185636,0.00248555,98.23186383
2418,毅,殳,15,30,1185666,0.00248555,98.23434938
2419,薯,艸,17,30,1185696,0.00248555,98.23683493
2420,贈,貝,19,30,1185726,0.00248555,98.23932048
2421,蕩,艸,16,30,1185756,0.00248555,98.24180603
2422,蹄,足,16,30,1185786,0.00248555,98.24429158
2423,濱,水,17,30,1185816,0.00248555,98.24677713
2424,鶯,鳥,21,30,1185846,0.00248555,98.24926268
2425,澡,水,16,30,1185876,0.00248555,98.25174823
2426,饒,食,20,30,1185906,0.00248555,98.25423378
2427,嚼,口,20,30,1185936,0.00248555,98.25671933
2428,驢,馬,26,30,1185966,0.00248555,98.25920488
2429,劣,力,6,29,1185995,0.00240270,98.26160758
2430,屯,屮,4,29,1186024,0.00240270,98.26401028
2431,卑,十,8,29,1186053,0.00240270,98.26641298
2432,娟,女,10,29,1186082,0.00240270,98.26881568
2433,坊,土,7,29,1186111,0.00240270,98.27121838
2434,桑,木,10,29,1186140,0.00240270,98.27362108
2435,售,口,11,29,1186169,0.00240270,98.27602378
2436,秧,禾,10,29,1186198,0.00240270,98.27842648
2437,哄,口,9,29,1186227,0.00240270,98.28082918
2438,凋,ち,10,29,1186256,0.00240270,98.28323188
2439,啪,口,11,29,1186285,0.00240270,98.28563458
2440,廁,な,12,29,1186314,0.00240270,98.28803728
2441,崩,山,11,29,1186343,0.00240270,98.29043998
2442,掠,手,11,29,1186372,0.00240270,98.29284268
2443,棍,木,12,29,1186401,0.00240270,98.29524538
2444,糞,米,17,29,1186430,0.00240270,98.29764808
2445,焰,火,12,29,1186459,0.00240270,98.30005078
2446,蕊,艸,16,29,1186488,0.00240270,98.30245348
2447,嗡,口,13,29,1186517,0.00240270,98.30485618
2448,嚕,口,18,29,1186546,0.00240270,98.30725888
2449,蛾,虫,13,29,1186575,0.00240270,98.30966158
2450,鯨,魚,19,29,1186604,0.00240270,98.31206428
2451,頌,頁,13,29,1186633,0.00240270,98.31446698
2452,蠻,虫,25,29,1186662,0.00240270,98.31686968
2453,誓,言,14,29,1186691,0.00240270,98.31927238
2454,攀,手,19,29,1186720,0.00240270,98.32167508
2455,謠,言,17,29,1186749,0.00240270,98.32407778
2456,鷺,鳥,24,29,1186778,0.00240270,98.32648048
2457,摺,手,14,29,1186807,0.00240270,98.32888318
2458,懈,心,16,29,1186836,0.00240270,98.33128588
2459,擲,手,18,29,1186865,0.00240270,98.33368858
2460,暈,日,13,29,1186894,0.00240270,98.33609128
2461,寞,で,14,29,1186923,0.00240270,98.33849398
2462,劭,力,7,29,1186952,0.00240270,98.34089668
2463,孕,子,5,28,1186980,0.00231985,98.34321653
2464,丐,一,4,28,1187008,0.00231985,98.34553638
2465,抄,手,7,28,1187036,0.00231985,98.34785623
2466,沃,水,7,28,1187064,0.00231985,98.35017608
2467,肖,肉,7,28,1187092,0.00231985,98.35249593
2468,賈,貝,13,28,1187120,0.00231985,98.35481578
2469,邪,邑,7,28,1187148,0.00231985,98.35713563
2470,靖,青,13,28,1187176,0.00231985,98.35945548
2471,框,木,10,28,1187204,0.00231985,98.36177533
2472,違,ひ,13,28,1187232,0.00231985,98.36409518
2473,唔,口,10,28,1187260,0.00231985,98.36641503
2474,駐,馬,15,28,1187288,0.00231985,98.36873488
2475,躬,身,10,28,1187316,0.00231985,98.37105473
2476,噪,口,16,28,1187344,0.00231985,98.37337458
2477,袖,衣,11,28,1187372,0.00231985,98.37569443
2478,蕾,艸,17,28,1187400,0.00231985,98.37801428
2479,蜓,虫,13,28,1187428,0.00231985,98.38033413
2480,蹲,足,19,28,1187456,0.00231985,98.38265398
2481,窄,穴,10,28,1187484,0.00231985,98.38497383
2482,戚,戈,11,28,1187512,0.00231985,98.38729368
2483,塌,土,13,28,1187540,0.00231985,98.38961353
2484,赴,走,9,28,1187568,0.00231985,98.39193338
2485,辱,辰,10,28,1187596,0.00231985,98.39425323
2486,鵑,鳥,18,28,1187624,0.00231985,98.39657308
2487,菇,艸,12,28,1187652,0.00231985,98.39889293
2488,欠,欠,4,27,1187679,0.00223699,98.40112992
2489,凹,凵,5,27,1187706,0.00223699,98.40336691
2490,寸,寸,3,27,1187733,0.00223699,98.40560390
2491,杉,木,7,27,1187760,0.00223699,98.40784089
2492,毀,殳,13,27,1187787,0.00223699,98.41007788
2493,嗅,口,13,27,1187814,0.00223699,98.41231487
2494,沾,水,8,27,1187841,0.00223699,98.41455186
2495,肆,聿,13,27,1187868,0.00223699,98.41678885
2496,洽,水,9,27,1187895,0.00223699,98.41902584
2497,彰,ね,14,27,1187922,0.00223699,98.42126283
2498,租,禾,10,27,1187949,0.00223699,98.42349982
2499,瑩,玉,15,27,1187976,0.00223699,98.42573681
2500,剖,刀,10,27,1188003,0.00223699,98.42797380
2501,辣,辛,14,27,1188030,0.00223699,98.43021079
2502,狹,犬,10,27,1188057,0.00223699,98.43244778
2503,鴻,鳥,17,27,1188084,0.00223699,98.43468477
2504,侏,人,8,27,1188111,0.00223699,98.43692176
2505,礁,石,17,27,1188138,0.00223699,98.43915875
2506,俄,人,9,27,1188165,0.00223699,98.44139574
2507,耗,耒,10,27,1188192,0.00223699,98.44363273
2508,逗,ひ,11,27,1188219,0.00223699,98.44586972
2509,缸,缶,9,27,1188246,0.00223699,98.44810671
2510,埔,土,10,27,1188273,0.00223699,98.45034370
2511,戀,心,23,27,1188300,0.00223699,98.45258069
2512,允,儿,4,26,1188326,0.00215414,98.45473483
2513,坑,土,7,26,1188352,0.00215414,98.45688897
2514,沈,水,7,26,1188378,0.00215414,98.45904311
2515,咱,口,9,26,1188404,0.00215414,98.46119725
2516,俯,人,10,26,1188430,0.00215414,98.46335139
2517,彌,弓,17,26,1188456,0.00215414,98.46550553
2518,倉,人,10,26,1188482,0.00215414,98.46765967
2519,颼,風,19,26,1188508,0.00215414,98.46981381
2520,萎,艸,12,26,1188534,0.00215414,98.47196795
2521,韌,韋,12,26,1188560,0.00215414,98.47412209
2522,棘,木,12,26,1188586,0.00215414,98.47627623
2523,窟,穴,13,26,1188612,0.00215414,98.47843037
2524,頒,頁,13,26,1188638,0.00215414,98.48058451
2525,盞,皿,13,26,1188664,0.00215414,98.48273865
2526,蜻,虫,14,26,1188690,0.00215414,98.48489279
2527,蓬,艸,15,26,1188716,0.00215414,98.48704693
2528,拳,手,10,26,1188742,0.00215414,98.48920107
2529,催,人,13,26,1188768,0.00215414,98.49135521
2530,扎,手,4,25,1188793,0.00207129,98.49342650
2531,估,人,7,25,1188818,0.00207129,98.49549779
2532,刮,刀,8,25,1188843,0.00207129,98.49756908
2533,弦,弓,8,25,1188868,0.00207129,98.49964037
2534,拘,手,8,25,1188893,0.00207129,98.50171166
2535,姍,女,8,25,1188918,0.00207129,98.50378295
2536,契,大,9,25,1188943,0.00207129,98.50585424
2537,姻,女,9,25,1188968,0.00207129,98.50792553
2538,削,刀,9,25,1188993,0.00207129,98.50999682
2539,倦,人,10,25,1189018,0.00207129,98.51206811
2540,剝,刀,10,25,1189043,0.00207129,98.51413940
2541,歇,欠,13,25,1189068,0.00207129,98.51621069
2542,矩,矢,10,25,1189093,0.00207129,98.51828198
2543,聘,耳,13,25,1189118,0.00207129,98.52035327
2544,郡,邑,10,25,1189143,0.00207129,98.52242456
2545,樑,木,15,25,1189168,0.00207129,98.52449585
2546,笠,竹,11,25,1189193,0.00207129,98.52656714
2547,噸,口,16,25,1189218,0.00207129,98.52863843
2548,梢,木,11,25,1189243,0.00207129,98.53070972
2549,膝,肉,15,25,1189268,0.00207129,98.53278101
2550,筑,竹,12,25,1189293,0.00207129,98.53485230
2551,膨,肉,16,25,1189318,0.00207129,98.53692359
2552,溢,水,13,25,1189343,0.00207129,98.53899488
2553,檔,木,17,25,1189368,0.00207129,98.54106617
2554,揉,手,12,25,1189393,0.00207129,98.54313746
2555,酥,酉,12,25,1189418,0.00207129,98.54520875
2556,湊,水,12,25,1189443,0.00207129,98.54728004
2557,恕,心,10,25,1189468,0.00207129,98.54935133
2558,喀,口,12,25,1189493,0.00207129,98.55142262
2559,瞬,目,17,25,1189518,0.00207129,98.55349391
2560,濁,水,16,25,1189543,0.00207129,98.55556520
2561,謊,言,17,25,1189568,0.00207129,98.55763649
2562,簾,竹,19,25,1189593,0.00207129,98.55970778
2563,蠅,虫,19,25,1189618,0.00207129,98.56177907
2564,旱,日,7,24,1189642,0.00198844,98.56376751
2565,竊,穴,23,24,1189666,0.00198844,98.56575595
2566,櫻,木,21,24,1189690,0.00198844,98.56774439
2567,衍,行,9,24,1189714,0.00198844,98.56973283
2568,茜,艸,10,24,1189738,0.00198844,98.57172127
2569,淒,水,11,24,1189762,0.00198844,98.57370971
2570,緞,糸,15,24,1189786,0.00198844,98.57569815
2571,惹,心,13,24,1189810,0.00198844,98.57768659
2572,誘,言,14,24,1189834,0.00198844,98.57967503
2573,肅,聿,12,24,1189858,0.00198844,98.58166347
2574,蔥,艸,15,24,1189882,0.00198844,98.58365191
2575,菊,艸,12,24,1189906,0.00198844,98.58564035
2576,嚀,口,17,24,1189930,0.00198844,98.58762879
2577,槓,木,14,24,1189954,0.00198844,98.58961723
2578,螳,虫,17,24,1189978,0.00198844,98.59160567
2579,蜢,虫,14,24,1190002,0.00198844,98.59359411
2580,顫,頁,22,24,1190026,0.00198844,98.59558255
2581,琪,玉,12,24,1190050,0.00198844,98.59757099
2582,逼,ひ,13,24,1190074,0.00198844,98.59955943
2583,裳,衣,14,24,1190098,0.00198844,98.60154787
2584,蔭,艸,15,24,1190122,0.00198844,98.60353631
2585,傭,人,13,24,1190146,0.00198844,98.60552475
2586,瀝,水,19,24,1190170,0.00198844,98.60751319
2587,蹦,足,18,24,1190194,0.00198844,98.60950163
2588,杖,木,7,24,1190218,0.00198844,98.61149007
2589,娛,女,10,24,1190242,0.00198844,98.61347851
2590,硫,石,11,24,1190266,0.00198844,98.61546695
2591,肋,肉,6,23,1190289,0.00190559,98.61737254
2592,炭,火,9,23,1190312,0.00190559,98.61927813
2593,丸,せ,3,23,1190335,0.00190559,98.62118372
2594,豈,豆,10,23,1190358,0.00190559,98.62308931
2595,函,凵,8,23,1190381,0.00190559,98.62499490
2596,殷,殳,10,23,1190404,0.00190559,98.62690049
2597,拌,手,8,23,1190427,0.00190559,98.62880608
2598,堊,土,11,23,1190450,0.00190559,98.63071167
2599,旺,日,8,23,1190473,0.00190559,98.63261726
2600,偽,人,11,23,1190496,0.00190559,98.63452285
2601,宛,で,8,23,1190519,0.00190559,98.63642844
2602,栗,木,10,23,1190542,0.00190559,98.63833403
2603,斥,斤,5,23,1190565,0.00190559,98.64023962
2604,咕,口,8,23,1190588,0.00190559,98.64214521
2605,妒,女,7,23,1190611,0.00190559,98.64405080
2606,盲,目,8,23,1190634,0.00190559,98.64595639
2607,妝,女,7,23,1190657,0.00190559,98.64786198
2608,御,彳,11,23,1190680,0.00190559,98.64976757
2609,淵,水,11,23,1190703,0.00190559,98.65167316
2610,眶,目,11,23,1190726,0.00190559,98.65357875
2611,訣,言,11,23,1190749,0.00190559,98.65548434
2612,媳,女,13,23,1190772,0.00190559,98.65738993
2613,渦,水,12,23,1190795,0.00190559,98.65929552
2614,藹,艸,20,23,1190818,0.00190559,98.66120111
2615,焚,火,12,23,1190841,0.00190559,98.66310670
2616,噠,口,16,23,1190864,0.00190559,98.66501229
2617,棺,木,12,23,1190887,0.00190559,98.66691788
2618,膏,肉,14,23,1190910,0.00190559,98.66882347
2619,僧,人,14,23,1190933,0.00190559,98.67072906
2620,槌,木,14,23,1190956,0.00190559,98.67263465
2621,盟,皿,13,23,1190979,0.00190559,98.67454024
2622,鋤,金,15,23,1191002,0.00190559,98.67644583
2623,輯,車,16,23,1191025,0.00190559,98.67835142
2624,襯,衣,22,23,1191048,0.00190559,98.68025701
2625,募,力,13,23,1191071,0.00190559,98.68216260
2626,碟,石,14,23,1191094,0.00190559,98.68406819
2627,兮,八,4,22,1191116,0.00182274,98.68589093
2628,戈,戈,4,22,1191138,0.00182274,98.68771367
2629,丫,｜,3,22,1191160,0.00182274,98.68953641
2630,杞,木,7,22,1191182,0.00182274,98.69135915
2631,虐,虍,9,22,1191204,0.00182274,98.69318189
2632,咽,口,9,22,1191226,0.00182274,98.69500463
2633,峻,山,10,22,1191248,0.00182274,98.69682737
2634,軒,車,10,22,1191270,0.00182274,98.69865011
2635,蚓,虫,10,22,1191292,0.00182274,98.70047285
2636,烘,火,10,22,1191314,0.00182274,98.70229559
2637,哨,口,10,22,1191336,0.00182274,98.70411833
2638,竭,立,14,22,1191358,0.00182274,98.70594107
2639,陛,阜,10,22,1191380,0.00182274,98.70776381
2640,碘,石,13,22,1191402,0.00182274,98.70958655
2641,惟,心,11,22,1191424,0.00182274,98.71140929
2642,澗,水,15,22,1191446,0.00182274,98.71323203
2643,趾,足,11,22,1191468,0.00182274,98.71505477
2644,潘,水,15,22,1191490,0.00182274,98.71687751
2645,烽,火,11,22,1191512,0.00182274,98.71870025
2646,鞠,革,17,22,1191534,0.00182274,98.72052299
2647,匯,匚,13,22,1191556,0.00182274,98.72234573
2648,霞,雨,17,22,1191578,0.00182274,98.72416847
2649,遂,ひ,13,22,1191600,0.00182274,98.72599121
2650,懇,心,17,22,1191622,0.00182274,98.72781395
2651,崑,山,11,22,1191644,0.00182274,98.72963669
2652,蚱,虫,11,22,1191666,0.00182274,98.73145943
2653,酬,酉,13,22,1191688,0.00182274,98.73328217
2654,畦,田,11,22,1191710,0.00182274,98.73510491
2655,販,貝,11,22,1191732,0.00182274,98.73692765
2656,錫,金,16,22,1191754,0.00182274,98.73875039
2657,磷,石,17,22,1191776,0.00182274,98.74057313
2658,禦,示,16,22,1191798,0.00182274,98.74239587
2659,攪,手,23,22,1191820,0.00182274,98.74421861
2660,籬,竹,25,22,1191842,0.00182274,98.74604135
2661,鰭,魚,21,22,1191864,0.00182274,98.74786409
2662,篷,竹,17,21,1191885,0.00173988,98.74960397
2663,豫,豕,16,21,1191906,0.00173988,98.75134385
2664,劫,力,7,21,1191927,0.00173988,98.75308373
2665,篩,竹,16,21,1191948,0.00173988,98.75482361
2666,拯,手,9,21,1191969,0.00173988,98.75656349
2667,籤,竹,23,21,1191990,0.00173988,98.75830337
2668,祀,示,8,21,1192011,0.00173988,98.76004325
2669,鹹,鹵,20,21,1192032,0.00173988,98.76178313
2670,涓,水,10,21,1192053,0.00173988,98.76352301
2671,翹,羽,18,21,1192074,0.00173988,98.76526289
2672,挽,手,10,21,1192095,0.00173988,98.76700277
2673,醬,酉,18,21,1192116,0.00173988,98.76874265
2674,蚯,虫,11,21,1192137,0.00173988,98.77048253
2675,鷗,鳥,22,21,1192158,0.00173988,98.77222241
2676,椰,木,13,21,1192179,0.00173988,98.77396229
2677,樞,木,15,21,1192200,0.00173988,98.77570217
2678,旬,日,6,21,1192221,0.00173988,98.77744205
2679,蓄,艸,14,21,1192242,0.00173988,98.77918193
2680,吝,口,7,21,1192263,0.00173988,98.78092181
2681,澈,水,14,21,1192284,0.00173988,98.78266169
2682,糾,糸,8,21,1192305,0.00173988,98.78440157
2683,鋁,金,15,21,1192326,0.00173988,98.78614145
2684,衙,行,13,21,1192347,0.00173988,98.78788133
2685,弊,廾,14,21,1192368,0.00173988,98.78962121
2686,駝,馬,15,21,1192389,0.00173988,98.79136109
2687,嬉,女,15,21,1192410,0.00173988,98.79310097
2688,胰,肉,10,21,1192431,0.00173988,98.79484085
2689,婉,女,11,21,1192452,0.00173988,98.79658073
2690,崙,山,11,21,1192473,0.00173988,98.79832061
2691,煌,火,13,21,1192494,0.00173988,98.80006049
2692,裹,衣,14,21,1192515,0.00173988,98.80180037
2693,肝,肉,7,20,1192535,0.00165703,98.80345740
2694,峭,山,10,20,1192555,0.00165703,98.80511443
2695,畝,田,10,20,1192575,0.00165703,98.80677146
2696,扭,手,7,20,1192595,0.00165703,98.80842849
2697,氫,气,11,20,1192615,0.00165703,98.81008552
2698,屑,尸,10,20,1192635,0.00165703,98.81174255
2699,涯,水,11,20,1192655,0.00165703,98.81339958
2700,茱,艸,10,20,1192675,0.00165703,98.81505661
2701,刪,刀,7,20,1192695,0.00165703,98.81671364
2702,叛,又,9,20,1192715,0.00165703,98.81837067
2703,蚩,虫,10,20,1192735,0.00165703,98.82002770
2704,陡,阜,10,20,1192755,0.00165703,98.82168473
2705,寇,で,11,20,1192775,0.00165703,98.82334176
2706,紮,糸,11,20,1192795,0.00165703,98.82499879
2707,喳,口,12,20,1192815,0.00165703,98.82665582
2708,傅,人,12,20,1192835,0.00165703,98.82831285
2709,鈍,金,12,20,1192855,0.00165703,98.82996988
2710,爍,火,19,20,1192875,0.00165703,98.83162691
2711,雇,隹,12,20,1192895,0.00165703,98.83328394
2712,顛,頁,19,20,1192915,0.00165703,98.83494097
2713,葦,艸,13,20,1192935,0.00165703,98.83659800
2714,鏈,金,19,20,1192955,0.00165703,98.83825503
2715,墜,土,15,20,1192975,0.00165703,98.83991206
2716,鰓,魚,20,20,1192995,0.00165703,98.84156909
2717,樵,木,16,20,1193015,0.00165703,98.84322612
2718,闢,門,21,20,1193035,0.00165703,98.84488315
2719,穎,禾,16,20,1193055,0.00165703,98.84654018
2720,轍,車,18,20,1193075,0.00165703,98.84819721
2721,頰,頁,16,20,1193095,0.00165703,98.84985424
2722,鏽,金,20,20,1193115,0.00165703,98.85151127
2723,憾,心,16,20,1193135,0.00165703,98.85316830
2724,橙,木,16,20,1193155,0.00165703,98.85482533
2725,黛,黑,17,20,1193175,0.00165703,98.85648236
2726,暨,日,14,20,1193195,0.00165703,98.85813939
2727,暮,日,15,20,1193215,0.00165703,98.85979642
2728,搧,手,13,20,1193235,0.00165703,98.86145345
2729,矛,矛,5,19,1193254,0.00157418,98.86302763
2730,禾,禾,5,19,1193273,0.00157418,98.86460181
2731,吏,口,6,19,1193292,0.00157418,98.86617599
2732,妃,女,6,19,1193311,0.00157418,98.86775017
2733,禿,禾,7,19,1193330,0.00157418,98.86932435
2734,鈕,金,12,19,1193349,0.00157418,98.87089853
2735,剎,刀,9,19,1193368,0.00157418,98.87247271
2736,煎,火,13,19,1193387,0.00157418,98.87404689
2737,秩,禾,10,19,1193406,0.00157418,98.87562107
2738,撇,手,14,19,1193425,0.00157418,98.87719525
2739,彭,ね,12,19,1193444,0.00157418,98.87876943
2740,鉅,金,13,19,1193463,0.00157418,98.88034361
2741,崗,山,11,19,1193482,0.00157418,98.88191779
2742,馴,馬,13,19,1193501,0.00157418,98.88349197
2743,逮,ひ,12,19,1193520,0.00157418,98.88506615
2744,褒,衣,15,19,1193539,0.00157418,98.88664033
2745,隋,阜,12,19,1193558,0.00157418,98.88821451
2746,儂,人,15,19,1193577,0.00157418,98.88978869
2747,掙,手,11,19,1193596,0.00157418,98.89136287
2748,嫉,女,13,19,1193615,0.00157418,98.89293705
2749,菩,艸,12,19,1193634,0.00157418,98.89451123
2750,咩,口,9,19,1193653,0.00157418,98.89608541
2751,淹,水,11,19,1193672,0.00157418,98.89765959
2752,豌,豆,15,19,1193691,0.00157418,98.89923377
2753,翩,羽,15,19,1193710,0.00157418,98.90080795
2754,錐,金,16,19,1193729,0.00157418,98.90238213
2755,駱,馬,16,19,1193748,0.00157418,98.90395631
2756,穌,禾,16,19,1193767,0.00157418,98.90553049
2757,蟀,虫,17,19,1193786,0.00157418,98.90710467
2758,麟,鹿,23,19,1193805,0.00157418,98.90867885
2759,嚮,口,18,19,1193824,0.00157418,98.91025303
2760,鵬,鳥,19,19,1193843,0.00157418,98.91182721
2761,鬚,髟,22,19,1193862,0.00157418,98.91340139
2762,雛,隹,18,19,1193881,0.00157418,98.91497557
2763,攔,手,20,19,1193900,0.00157418,98.91654975
2764,躁,足,20,19,1193919,0.00157418,98.91812393
2765,浞,水,10,19,1193938,0.00157418,98.91969811
2766,朽,木,6,18,1193956,0.00149133,98.92118944
2767,丞,一,6,18,1193974,0.00149133,98.92268077
2768,余,人,7,18,1193992,0.00149133,98.92417210
2769,坪,土,8,18,1194010,0.00149133,98.92566343
2770,怠,心,9,18,1194028,0.00149133,98.92715476
2771,吾,口,7,18,1194046,0.00149133,98.92864609
2772,奕,大,9,18,1194064,0.00149133,98.93013742
2773,拭,手,9,18,1194082,0.00149133,98.93162875
2774,咳,口,9,18,1194100,0.00149133,98.93312008
2775,咀,口,8,18,1194118,0.00149133,98.93461141
2776,陀,阜,8,18,1194136,0.00149133,98.93610274
2777,衷,衣,10,18,1194154,0.00149133,98.93759407
2778,挾,手,10,18,1194172,0.00149133,98.93908540
2779,砰,石,10,18,1194190,0.00149133,98.94057673
2780,堵,土,11,18,1194208,0.00149133,98.94206806
2781,淅,水,11,18,1194226,0.00149133,98.94355939
2782,釉,釆,13,18,1194244,0.00149133,98.94505072
2783,碩,石,14,18,1194262,0.00149133,98.94654205
2784,喙,口,12,18,1194280,0.00149133,98.94803338
2785,槳,木,15,18,1194298,0.00149133,98.94952471
2786,暉,日,13,18,1194316,0.00149133,98.95101604
2787,霄,雨,15,18,1194334,0.00149133,98.95250737
2788,逸,ひ,12,18,1194352,0.00149133,98.95399870
2789,誨,言,14,18,1194370,0.00149133,98.95549003
2790,稅,禾,12,18,1194388,0.00149133,98.95698136
2791,噓,口,15,18,1194406,0.00149133,98.95847269
2792,甄,瓦,14,18,1194424,0.00149133,98.95996402
2793,蝠,虫,15,18,1194442,0.00149133,98.96145535
2794,堯,土,12,18,1194460,0.00149133,98.96294668
2795,颳,風,15,18,1194478,0.00149133,98.96443801
2796,廈,な,13,18,1194496,0.00149133,98.96592934
2797,蒜,艸,14,18,1194514,0.00149133,98.96742067
2798,隕,阜,13,18,1194532,0.00149133,98.96891200
2799,眺,目,11,18,1194550,0.00149133,98.97040333
2800,琢,玉,12,18,1194568,0.00149133,98.97189466
2801,蟋,虫,17,18,1194586,0.00149133,98.97338599
2802,穗,禾,17,18,1194604,0.00149133,98.97487732
2803,燙,火,16,18,1194622,0.00149133,98.97636865
2804,磺,石,17,18,1194640,0.00149133,98.97785998
2805,諧,言,16,18,1194658,0.00149133,98.97935131
2806,禪,示,17,18,1194676,0.00149133,98.98084264
2807,釐,里,18,18,1194694,0.00149133,98.98233397
2808,櫥,木,19,18,1194712,0.00149133,98.98382530
2809,髓,骨,23,18,1194730,0.00149133,98.98531663
2810,黴,黑,23,18,1194748,0.00149133,98.98680796
2811,躡,足,25,18,1194766,0.00149133,98.98829929
2812,蠢,虫,21,18,1194784,0.00149133,98.98979062
2813,疆,田,19,18,1194802,0.00149133,98.99128195
2814,艦,舟,20,18,1194820,0.00149133,98.99277328
2815,壼,士,13,18,1194838,0.00149133,98.99426461
2816,籲,竹,32,18,1194856,0.00149133,98.99575594
2817,啥,口,11,18,1194874,0.00149133,98.99724727
2818,吒,口,6,17,1194891,0.00140848,98.99865575
2819,呱,口,8,17,1194908,0.00140848,99.00006423
2820,奸,女,6,17,1194925,0.00140848,99.00147271
2821,乍,ぜ,5,17,1194942,0.00140848,99.00288119
2822,曰,曰,4,17,1194959,0.00140848,99.00428967
2823,券,刀,8,17,1194976,0.00140848,99.00569815
2824,兆,儿,6,17,1194993,0.00140848,99.00710663
2825,杆,木,7,17,1195010,0.00140848,99.00851511
2826,砌,石,9,17,1195027,0.00140848,99.00992359
2827,秉,禾,8,17,1195044,0.00140848,99.01133207
2828,咸,口,9,17,1195061,0.00140848,99.01274055
2829,徊,彳,9,17,1195078,0.00140848,99.01414903
2830,倘,人,10,17,1195095,0.00140848,99.01555751
2831,萍,艸,12,17,1195112,0.00140848,99.01696599
2832,凰,几,11,17,1195129,0.00140848,99.01837447
2833,菸,艸,12,17,1195146,0.00140848,99.01978295
2834,捆,手,10,17,1195163,0.00140848,99.02119143
2835,棕,木,12,17,1195180,0.00140848,99.02259991
2836,笙,竹,11,17,1195197,0.00140848,99.02400839
2837,裘,衣,13,17,1195214,0.00140848,99.02541687
2838,敕,の,11,17,1195231,0.00140848,99.02682535
2839,箕,竹,14,17,1195248,0.00140848,99.02823383
2840,徜,彳,11,17,1195265,0.00140848,99.02964231
2841,慚,心,14,17,1195282,0.00140848,99.03105079
2842,雁,隹,12,17,1195299,0.00140848,99.03245927
2843,蒲,艸,14,17,1195316,0.00140848,99.03386775
2844,聆,耳,11,17,1195333,0.00140848,99.03527623
2845,徘,彳,11,17,1195350,0.00140848,99.03668471
2846,絨,糸,12,17,1195367,0.00140848,99.03809319
2847,脂,肉,10,17,1195384,0.00140848,99.03950167
2848,晝,日,11,17,1195401,0.00140848,99.04091015
2849,寢,で,14,17,1195418,0.00140848,99.04231863
2850,蛻,虫,13,17,1195435,0.00140848,99.04372711
2851,壇,土,16,17,1195452,0.00140848,99.04513559
2852,賦,貝,15,17,1195469,0.00140848,99.04654407
2853,蝙,虫,15,17,1195486,0.00140848,99.04795255
2854,誦,言,14,17,1195503,0.00140848,99.04936103
2855,攤,手,22,17,1195520,0.00140848,99.05076951
2856,儉,人,15,17,1195537,0.00140848,99.05217799
2857,鰻,魚,22,17,1195554,0.00140848,99.05358647
2858,凜,ち,15,17,1195571,0.00140848,99.05499495
2859,壩,土,24,17,1195588,0.00140848,99.05640343
2860,瞎,目,15,17,1195605,0.00140848,99.05781191
2861,鵡,鳥,19,17,1195622,0.00140848,99.05922039
2862,壘,土,18,17,1195639,0.00140848,99.06062887
2863,巒,山,22,17,1195656,0.00140848,99.06203735
2864,橢,木,16,17,1195673,0.00140848,99.06344583
2865,鸚,鳥,28,17,1195690,0.00140848,99.06485431
2866,罈,缶,18,17,1195707,0.00140848,99.06626279
2867,賠,貝,15,17,1195724,0.00140848,99.06767127
2868,鍛,金,17,17,1195741,0.00140848,99.06907975
2869,鴕,鳥,16,17,1195758,0.00140848,99.07048823
2870,擎,手,17,17,1195775,0.00140848,99.07189671
2871,諄,言,15,17,1195792,0.00140848,99.07330519
2872,汀,水,5,16,1195808,0.00132563,99.07463082
2873,勿,ぢ,4,16,1195824,0.00132563,99.07595645
2874,勾,ぢ,4,16,1195840,0.00132563,99.07728208
2875,沛,水,7,16,1195856,0.00132563,99.07860771
2876,罕,网,7,16,1195872,0.00132563,99.07993334
2877,拂,手,8,16,1195888,0.00132563,99.08125897
2878,茅,艸,9,16,1195904,0.00132563,99.08258460
2879,悽,心,11,16,1195920,0.00132563,99.08391023
2880,斬,斤,11,16,1195936,0.00132563,99.08523586
2881,砲,石,10,16,1195952,0.00132563,99.08656149
2882,頃,頁,11,16,1195968,0.00132563,99.08788712
2883,栩,木,10,16,1195984,0.00132563,99.08921275
2884,愣,心,12,16,1196000,0.00132563,99.09053838
2885,耽,耳,10,16,1196016,0.00132563,99.09186401
2886,琅,玉,11,16,1196032,0.00132563,99.09318964
2887,盔,皿,11,16,1196048,0.00132563,99.09451527
2888,搓,手,13,16,1196064,0.00132563,99.09584090
2889,喧,口,12,16,1196080,0.00132563,99.09716653
2890,筍,竹,12,16,1196096,0.00132563,99.09849216
2891,沫,水,8,16,1196112,0.00132563,99.09981779
2892,楓,木,13,16,1196128,0.00132563,99.10114342
2893,啞,口,11,16,1196144,0.00132563,99.10246905
2894,揍,手,12,16,1196160,0.00132563,99.10379468
2895,惶,心,12,16,1196176,0.00132563,99.10512031
2896,脅,肉,10,16,1196192,0.00132563,99.10644594
2897,堤,土,12,16,1196208,0.00132563,99.10777157
2898,稜,禾,13,16,1196224,0.00132563,99.10909720
2899,窪,穴,14,16,1196240,0.00132563,99.11042283
2900,蓉,艸,14,16,1196256,0.00132563,99.11174846
2901,蜿,虫,14,16,1196272,0.00132563,99.11307409
2902,嘎,口,14,16,1196288,0.00132563,99.11439972
2903,寮,で,15,16,1196304,0.00132563,99.11572535
2904,襟,衣,19,16,1196320,0.00132563,99.11705098
2905,蔚,艸,15,16,1196336,0.00132563,99.11837661
2906,薦,艸,17,16,1196352,0.00132563,99.11970224
2907,閩,門,14,16,1196368,0.00132563,99.12102787
2908,欖,木,25,16,1196384,0.00132563,99.12235350
2909,濾,水,18,16,1196400,0.00132563,99.12367913
2910,蟬,虫,18,16,1196416,0.00132563,99.12500476
2911,踴,足,16,16,1196432,0.00132563,99.12633039
2913,薔,艸,17,16,1196464,0.00132563,99.12898165
2914,鬣,髟,25,16,1196480,0.00132563,99.13030728
2915,懿,心,22,16,1196496,0.00132563,99.13163291
2916,蜒,虫,14,16,1196512,0.00132563,99.13295854
2917,樟,木,15,16,1196528,0.00132563,99.13428417
2918,徽,彳,17,16,1196544,0.00132563,99.13560980
2919,曬,日,23,16,1196560,0.00132563,99.13693543
2920,慾,心,15,16,1196576,0.00132563,99.13826106
2921,諫,言,16,16,1196592,0.00132563,99.13958669
2922,摀,手,13,16,1196608,0.00132563,99.14091232
2923,廿,廾,4,15,1196623,0.00124277,99.14215509
2924,吁,口,6,15,1196638,0.00124277,99.14339786
2925,怯,心,8,15,1196653,0.00124277,99.14464063
2926,盯,目,7,15,1196668,0.00124277,99.14588340
2927,杰,木,8,15,1196683,0.00124277,99.14712617
2928,桐,木,10,15,1196698,0.00124277,99.14836894
2929,抑,手,7,15,1196713,0.00124277,99.14961171
2930,媛,女,12,15,1196728,0.00124277,99.15085448
2931,垢,土,9,15,1196743,0.00124277,99.15209725
2932,揀,手,12,15,1196758,0.00124277,99.15334002
2933,拱,手,9,15,1196773,0.00124277,99.15458279
2934,奠,大,12,15,1196788,0.00124277,99.15582556
2935,倩,人,10,15,1196803,0.00124277,99.15706833
2936,辜,辛,12,15,1196818,0.00124277,99.15831110
2937,琉,玉,10,15,1196833,0.00124277,99.15955387
2938,腎,肉,12,15,1196848,0.00124277,99.16079664
2939,冤,だ,10,15,1196863,0.00124277,99.16203941
2940,溺,水,13,15,1196878,0.00124277,99.16328218
2941,禹,禸,9,15,1196893,0.00124277,99.16452495
2942,俱,人,10,15,1196908,0.00124277,99.16576772
2943,畔,田,10,15,1196923,0.00124277,99.16701049
2944,徉,彳,9,15,1196938,0.00124277,99.16825326
2945,泄,水,8,15,1196953,0.00124277,99.16949603
2946,腕,肉,12,15,1196968,0.00124277,99.17073880
2947,湘,水,12,15,1196983,0.00124277,99.17198157
2948,氮,气,12,15,1196998,0.00124277,99.17322434
2949,菁,艸,12,15,1197013,0.00124277,99.17446711
2950,稠,禾,13,15,1197028,0.00124277,99.17570988
2951,睹,目,13,15,1197043,0.00124277,99.17695265
2952,償,人,17,15,1197058,0.00124277,99.17819542
2953,痴,ば,13,15,1197073,0.00124277,99.17943819
2954,骸,骨,16,15,1197088,0.00124277,99.18068096
2955,樁,木,15,15,1197103,0.00124277,99.18192373
2956,鮭,魚,17,15,1197118,0.00124277,99.18316650
2957,幟,巾,15,15,1197133,0.00124277,99.18440927
2958,瞿,目,18,15,1197148,0.00124277,99.18565204
2959,撮,手,15,15,1197163,0.00124277,99.18689481
2960,霖,雨,16,15,1197178,0.00124277,99.18813758
2961,魄,鬼,15,15,1197193,0.00124277,99.18938035
2962,濤,水,17,15,1197208,0.00124277,99.19062312
2963,蕨,艸,16,15,1197223,0.00124277,99.19186589
2964,瞞,目,16,15,1197238,0.00124277,99.19310866
2965,蔓,艸,15,15,1197253,0.00124277,99.19435143
2966,瞇,目,15,15,1197268,0.00124277,99.19559420
2967,賤,貝,15,15,1197283,0.00124277,99.19683697
2968,萱,艸,13,15,1197298,0.00124277,99.19807974
2969,瘤,ば,15,15,1197313,0.00124277,99.19932251
2970,糰,米,20,15,1197328,0.00124277,99.20056528
2971,繽,糸,20,15,1197343,0.00124277,99.20180805
2972,齦,齒,21,15,1197358,0.00124277,99.20305082
2973,鑰,金,25,15,1197373,0.00124277,99.20429359
2974,鑲,金,25,15,1197388,0.00124277,99.20553636
2975,戊,戈,5,14,1197402,0.00115992,99.20669628
2976,倡,人,10,14,1197416,0.00115992,99.20785620
2977,庸,な,11,14,1197430,0.00115992,99.20901612
2978,坤,土,8,14,1197444,0.00115992,99.21017604
2979,淳,水,11,14,1197458,0.00115992,99.21133596
2980,抒,手,7,14,1197472,0.00115992,99.21249588
2981,紳,糸,11,14,1197486,0.00115992,99.21365580
2982,伺,人,7,14,1197500,0.00115992,99.21481572
2983,梧,木,11,14,1197514,0.00115992,99.21597564
2984,恍,心,9,14,1197528,0.00115992,99.21713556
2985,唾,口,12,14,1197542,0.00115992,99.21829548
2986,砸,石,10,14,1197556,0.00115992,99.21945540
2987,崎,山,11,14,1197570,0.00115992,99.22061532
2988,卉,十,5,14,1197584,0.00115992,99.22177524
2989,舵,舟,11,14,1197598,0.00115992,99.22293516
2990,咖,口,8,14,1197612,0.00115992,99.22409508
2991,陋,阜,9,14,1197626,0.00115992,99.22525500
2992,啡,口,11,14,1197640,0.00115992,99.22641492
2993,杏,木,7,14,1197654,0.00115992,99.22757484
2994,疫,ば,9,14,1197668,0.00115992,99.22873476
2995,嵌,山,12,14,1197682,0.00115992,99.22989468
2996,債,人,13,14,1197696,0.00115992,99.23105460
2997,鈞,金,12,14,1197710,0.00115992,99.23221452
2998,搗,手,13,14,1197724,0.00115992,99.23337444
2999,煞,火,13,14,1197738,0.00115992,99.23453436
3000,詠,言,12,14,1197752,0.00115992,99.23569428
3001,癮,ば,22,14,1197766,0.00115992,99.23685420
3002,晰,日,12,14,1197780,0.00115992,99.23801412
3003,鏟,金,19,14,1197794,0.00115992,99.23917404
3004,筏,竹,12,14,1197808,0.00115992,99.24033396
3005,繭,糸,19,14,1197822,0.00115992,99.24149388
3006,溯,水,13,14,1197836,0.00115992,99.24265380
3007,鶴,鳥,21,14,1197850,0.00115992,99.24381372
3008,靴,革,13,14,1197864,0.00115992,99.24497364
3009,舖,舌,15,14,1197878,0.00115992,99.24613356
3010,鉀,金,13,14,1197892,0.00115992,99.24729348
3011,輻,車,16,14,1197906,0.00115992,99.24845340
3012,輾,車,17,14,1197920,0.00115992,99.24961332
3013,骯,骨,14,14,1197934,0.00115992,99.25077324
3014,瀉,水,18,14,1197948,0.00115992,99.25193316
3015,槽,木,15,14,1197962,0.00115992,99.25309308
3016,瀰,水,20,14,1197976,0.00115992,99.25425300
3017,嘶,口,15,14,1197990,0.00115992,99.25541292
3018,鐺,金,21,14,1198004,0.00115992,99.25657284
3019,簫,竹,18,14,1198018,0.00115992,99.25773276
3020,魁,鬼,14,14,1198032,0.00115992,99.25889268
3021,僻,人,15,14,1198046,0.00115992,99.26005260
3022,橄,木,16,14,1198060,0.00115992,99.26121252
3023,潰,水,15,14,1198074,0.00115992,99.26237244
3024,詛,言,12,14,1198088,0.00115992,99.26353236
3025,竣,立,12,14,1198102,0.00115992,99.26469228
3026,鄒,邑,13,14,1198116,0.00115992,99.26585220
3027,摟,手,14,14,1198130,0.00115992,99.26701212
3028,熬,火,15,14,1198144,0.00115992,99.26817204
3029,囚,囗,5,13,1198157,0.00107707,99.26924911
3030,昔,日,8,13,1198170,0.00107707,99.27032618
3031,咿,口,9,13,1198183,0.00107707,99.27140325
3032,皿,皿,5,13,1198196,0.00107707,99.27248032
3033,咻,口,9,13,1198209,0.00107707,99.27355739
3034,卸,つ,8,13,1198222,0.00107707,99.27463446
3035,芸,艸,8,13,1198235,0.00107707,99.27571153
3036,伶,人,7,13,1198248,0.00107707,99.27678860
3037,侮,人,9,13,1198261,0.00107707,99.27786567
3038,狄,犬,7,13,1198274,0.00107707,99.27894274
3040,呎,口,7,13,1198300,0.00107707,99.28109688
3041,姒,女,8,13,1198313,0.00107707,99.28217395
3042,氾,水,5,13,1198326,0.00107707,99.28325102
3043,茁,艸,9,13,1198339,0.00107707,99.28432809
3044,苑,艸,9,13,1198352,0.00107707,99.28540516
3045,冥,だ,10,13,1198365,0.00107707,99.28648223
3046,眩,目,10,13,1198378,0.00107707,99.28755930
3047,畚,田,10,13,1198391,0.00107707,99.28863637
3048,捏,手,10,13,1198404,0.00107707,99.28971344
3049,隧,阜,16,13,1198417,0.00107707,99.29079051
3050,糜,米,17,13,1198430,0.00107707,99.29186758
3051,彬,ね,11,13,1198443,0.00107707,99.29294465
3052,錘,金,17,13,1198456,0.00107707,99.29402172
3053,徙,彳,11,13,1198469,0.00107707,99.29509879
3054,癌,ば,17,13,1198482,0.00107707,99.29617586
3055,琵,玉,12,13,1198495,0.00107707,99.29725293
3056,檬,木,18,13,1198508,0.00107707,99.29833000
3057,鈣,金,12,13,1198521,0.00107707,99.29940707
3058,橇,木,16,13,1198534,0.00107707,99.30048414
3059,蜀,虫,13,13,1198547,0.00107707,99.30156121
3060,錶,金,16,13,1198560,0.00107707,99.30263828
3061,雍,隹,13,13,1198573,0.00107707,99.30371535
3062,囑,口,24,13,1198586,0.00107707,99.30479242
3063,瞄,目,14,13,1198599,0.00107707,99.30586949
3064,懲,心,19,13,1198612,0.00107707,99.30694656
3065,絹,糸,13,13,1198625,0.00107707,99.30802363
3066,譏,言,19,13,1198638,0.00107707,99.30910070
3067,懊,心,16,13,1198651,0.00107707,99.31017777
3068,糯,米,20,13,1198664,0.00107707,99.31125484
3069,幢,巾,15,13,1198677,0.00107707,99.31233191
3070,癢,ば,20,13,1198690,0.00107707,99.31340898
3071,濛,水,17,13,1198703,0.00107707,99.31448605
3072,靡,非,19,13,1198716,0.00107707,99.31556312
3073,圃,囗,10,13,1198729,0.00107707,99.31664019
3074,艷,色,24,13,1198742,0.00107707,99.31771726
3075,菱,艸,12,13,1198755,0.00107707,99.31879433
3076,竇,穴,20,13,1198768,0.00107707,99.31987140
3077,楣,木,13,13,1198781,0.00107707,99.32094847
3078,鬱,鬯,29,13,1198794,0.00107707,99.32202554
3079,裔,衣,13,13,1198807,0.00107707,99.32310261
3080,欒,木,23,13,1198820,0.00107707,99.32417968
3081,骰,骨,14,13,1198833,0.00107707,99.32525675
3082,椿,木,13,13,1198846,0.00107707,99.32633382
3083,縷,糸,17,13,1198859,0.00107707,99.32741089
3084,莽,艸,11,13,1198872,0.00107707,99.32848796
3085,黍,黍,12,13,1198885,0.00107707,99.32956503
3086,塾,土,14,13,1198898,0.00107707,99.33064210
3087,綴,糸,14,13,1198911,0.00107707,99.33171917
3088,敷,の,15,13,1198924,0.00107707,99.33279624
3089,蕙,艸,16,13,1198937,0.00107707,99.33387331
3090,勻,ぢ,4,12,1198949,0.00099422,99.33486753
3091,亙,二,6,12,1198961,0.00099422,99.33586175
3092,枉,木,8,12,1198973,0.00099422,99.33685597
3093,沐,水,7,12,1198985,0.00099422,99.33785019
3094,洶,水,9,12,1198997,0.00099422,99.33884441
3095,茉,艸,9,12,1199009,0.00099422,99.33983863
3096,苔,艸,9,12,1199021,0.00099422,99.34083285
3097,稽,禾,15,12,1199033,0.00099422,99.34182707
3098,竺,竹,8,12,1199045,0.00099422,99.34282129
3099,潦,水,15,12,1199057,0.00099422,99.34381551
3100,炙,火,8,12,1199069,0.00099422,99.34480973
3101,樺,木,16,12,1199081,0.00099422,99.34580395
3102,奢,大,11,12,1199093,0.00099422,99.34679817
3103,擱,手,17,12,1199105,0.00099422,99.34779239
3104,脣,肉,11,12,1199117,0.00099422,99.34878661
3105,襄,衣,17,12,1199129,0.00099422,99.34978083
3106,稈,禾,12,12,1199141,0.00099422,99.35077505
3107,閻,門,16,12,1199153,0.00099422,99.35176927
3108,欽,欠,12,12,1199165,0.00099422,99.35276349
3109,諦,言,16,12,1199177,0.00099422,99.35375771
3110,漩,水,14,12,1199189,0.00099422,99.35475193
3111,鎚,金,18,12,1199201,0.00099422,99.35574615
3112,滯,水,14,12,1199213,0.00099422,99.35674037
3113,癡,ば,19,12,1199225,0.00099422,99.35773459
3114,墅,土,14,12,1199237,0.00099422,99.35872881
3115,瓊,玉,19,12,1199249,0.00099422,99.35972303
3116,綢,糸,14,12,1199261,0.00099422,99.36071725
3117,騷,馬,20,12,1199273,0.00099422,99.36171147
3118,腥,肉,13,12,1199285,0.00099422,99.36270569
3119,筱,竹,13,12,1199297,0.00099422,99.36369991
3120,魅,鬼,15,12,1199309,0.00099422,99.36469413
3121,瑋,玉,13,12,1199321,0.00099422,99.36568835
3122,荀,艸,10,12,1199333,0.00099422,99.36668257
3123,呦,口,8,12,1199345,0.00099422,99.36767679
3124,掏,手,11,12,1199357,0.00099422,99.36867101
3125,浣,水,10,12,1199369,0.00099422,99.36966523
3126,暇,日,13,12,1199381,0.00099422,99.37065945
3127,腫,肉,13,12,1199393,0.00099422,99.37165367
3128,寡,で,14,12,1199405,0.00099422,99.37264789
3129,嘟,口,14,12,1199417,0.00099422,99.37364211
3130,嘹,口,15,12,1199429,0.00099422,99.37463633
3131,狩,犬,9,12,1199441,0.00099422,99.37563055
3132,偎,人,11,12,1199453,0.00099422,99.37662477
3133,聒,耳,12,12,1199465,0.00099422,99.37761899
3134,慷,心,14,12,1199477,0.00099422,99.37861321
3135,丑,一,4,11,1199488,0.00091137,99.37952458
3136,卜,卜,2,11,1199499,0.00091137,99.38043595
3137,仕,人,5,11,1199510,0.00091137,99.38134732
3138,坎,土,7,11,1199521,0.00091137,99.38225869
3139,拙,手,8,11,1199532,0.00091137,99.38317006
3140,灸,火,7,11,1199543,0.00091137,99.38408143
3141,迄,ひ,7,11,1199554,0.00091137,99.38499280
3142,忱,心,7,11,1199565,0.00091137,99.38590417
3143,迢,ひ,9,11,1199576,0.00091137,99.38681554
3144,昧,日,9,11,1199587,0.00091137,99.38772691
3145,祿,示,13,11,1199598,0.00091137,99.38863828
3146,摧,手,14,11,1199609,0.00091137,99.38954965
3147,俏,人,9,11,1199620,0.00091137,99.39046102
3148,翡,羽,14,11,1199631,0.00091137,99.39137239
3149,耿,耳,10,11,1199642,0.00091137,99.39228376
3150,筠,竹,13,11,1199653,0.00091137,99.39319513
3151,虔,虍,10,11,1199664,0.00091137,99.39410650
3152,瑤,玉,14,11,1199675,0.00091137,99.39501787
3153,匪,匚,10,11,1199686,0.00091137,99.39592924
3154,酵,酉,14,11,1199697,0.00091137,99.39684061
3155,焉,火,11,11,1199708,0.00091137,99.39775198
3156,鄙,邑,14,11,1199719,0.00091137,99.39866335
3157,淮,水,11,11,1199730,0.00091137,99.39957472
3158,瓢,瓜,16,11,1199741,0.00091137,99.40048609
3159,皎,白,11,11,1199752,0.00091137,99.40139746
3160,頹,頁,16,11,1199763,0.00091137,99.40230883
3161,廂,な,12,11,1199774,0.00091137,99.40322020
3162,瞰,目,17,11,1199785,0.00091137,99.40413157
3163,袱,衣,12,11,1199796,0.00091137,99.40504294
3164,蕪,艸,16,11,1199807,0.00091137,99.40595431
3165,嗇,口,13,11,1199818,0.00091137,99.40686568
3166,罹,网,16,11,1199829,0.00091137,99.40777705
3167,凳,几,14,11,1199840,0.00091137,99.40868842
3168,簇,竹,17,11,1199851,0.00091137,99.40959979
3169,洩,水,9,11,1199862,0.00091137,99.41051116
3170,檸,木,18,11,1199873,0.00091137,99.41142253
3171,盎,皿,10,11,1199884,0.00091137,99.41233390
3172,諷,言,16,11,1199895,0.00091137,99.41324527
3173,崁,山,10,11,1199906,0.00091137,99.41415664
3174,磯,石,17,11,1199917,0.00091137,99.41506801
3175,捺,手,11,11,1199928,0.00091137,99.41597938
3176,竄,穴,18,11,1199939,0.00091137,99.41689075
3177,羚,羊,11,11,1199950,0.00091137,99.41780212
3178,繳,糸,19,11,1199961,0.00091137,99.41871349
3179,甥,生,12,11,1199972,0.00091137,99.41962486
3180,闡,門,20,11,1199983,0.00091137,99.42053623
3181,祇,示,9,11,1199994,0.00091137,99.42144760
3182,籟,竹,22,11,1200005,0.00091137,99.42235897
3183,逍,ひ,11,11,1200016,0.00091137,99.42327034
3184,敞,の,12,11,1200027,0.00091137,99.42418171
3185,艇,舟,13,11,1200038,0.00091137,99.42509308
3186,剔,刀,10,11,1200049,0.00091137,99.42600445
3187,淇,水,11,11,1200060,0.00091137,99.42691582
3188,簷,竹,19,11,1200071,0.00091137,99.42782719
3189,襪,衣,21,11,1200082,0.00091137,99.42873856
3190,蠍,虫,19,11,1200093,0.00091137,99.42964993
3191,嚨,口,19,11,1200104,0.00091137,99.43056130
3192,聶,耳,18,11,1200115,0.00091137,99.43147267
3193,簸,竹,19,11,1200126,0.00091137,99.43238404
3194,瀕,水,19,11,1200137,0.00091137,99.43329541
3195,嚥,口,19,11,1200148,0.00091137,99.43420678
3196,驪,馬,29,11,1200159,0.00091137,99.43511815
3197,鸛,鳥,29,11,1200170,0.00091137,99.43602952
3198,厘,厂,9,11,1200181,0.00091137,99.43694089
3199,亥,ぞ,6,10,1200191,0.00082852,99.43776941
3200,曳,曰,6,10,1200201,0.00082852,99.43859793
3201,叨,口,5,10,1200211,0.00082852,99.43942645
3202,屹,山,6,10,1200221,0.00082852,99.44025497
3203,伕,人,6,10,1200231,0.00082852,99.44108349
3204,芋,艸,7,10,1200241,0.00082852,99.44191201
3205,冽,ち,8,10,1200251,0.00082852,99.44274053
3206,宦,で,9,10,1200261,0.00082852,99.44356905
3207,妾,女,8,10,1200271,0.00082852,99.44439757
3208,吠,口,7,10,1200281,0.00082852,99.44522609
3209,拚,手,8,10,1200291,0.00082852,99.44605461
3210,扳,手,7,10,1200301,0.00082852,99.44688313
3211,吶,口,7,10,1200311,0.00082852,99.44771165
3212,垣,土,9,10,1200321,0.00082852,99.44854017
3213,侶,人,9,10,1200331,0.00082852,99.44936869
3214,迦,ひ,9,10,1200341,0.00082852,99.45019721
3215,罔,网,8,10,1200351,0.00082852,99.45102573
3216,啃,口,11,10,1200361,0.00082852,99.45185425
3217,氦,气,10,10,1200371,0.00082852,99.45268277
3218,袍,衣,11,10,1200381,0.00082852,99.45351129
3219,兜,儿,11,10,1200391,0.00082852,99.45433981
3220,庶,な,11,10,1200401,0.00082852,99.45516833
3221,倚,人,10,10,1200411,0.00082852,99.45599685
3222,睏,目,12,10,1200421,0.00082852,99.45682537
3223,荐,艸,10,10,1200431,0.00082852,99.45765389
3224,渝,水,12,10,1200441,0.00082852,99.45848241
3225,珮,玉,10,10,1200451,0.00082852,99.45931093
3226,愴,心,13,10,1200461,0.00082852,99.46013945
3227,屠,尸,11,10,1200471,0.00082852,99.46096797
3228,貯,貝,12,10,1200481,0.00082852,99.46179649
3229,梗,木,11,10,1200491,0.00082852,99.46262501
3230,棗,木,12,10,1200501,0.00082852,99.46345353
3231,祟,示,10,10,1200511,0.00082852,99.46428205
3232,冕,た,11,10,1200521,0.00082852,99.46511057
3233,烹,火,11,10,1200531,0.00082852,99.46593909
3234,峨,山,10,10,1200541,0.00082852,99.46676761
3235,唇,口,10,10,1200551,0.00082852,99.46759613
3236,萌,艸,12,10,1200561,0.00082852,99.46842465
3237,貿,貝,12,10,1200571,0.00082852,99.46925317
3238,渣,水,12,10,1200581,0.00082852,99.47008169
3239,僑,人,14,10,1200591,0.00082852,99.47091021
3240,蓑,艸,14,10,1200601,0.00082852,99.47173873
3241,撤,手,14,10,1200611,0.00082852,99.47256725
3242,璨,玉,17,10,1200621,0.00082852,99.47339577
3243,錳,金,16,10,1200631,0.00082852,99.47422429
3244,葵,艸,13,10,1200641,0.00082852,99.47505281
3245,窺,穴,16,10,1200651,0.00082852,99.47588133
3246,綽,糸,14,10,1200661,0.00082852,99.47670985
3247,犢,牛,19,10,1200671,0.00082852,99.47753837
3248,跤,足,13,10,1200681,0.00082852,99.47836689
3249,鵲,鳥,19,10,1200691,0.00082852,99.47919541
3250,稟,禾,13,10,1200701,0.00082852,99.48002393
3251,蟾,虫,19,10,1200711,0.00082852,99.48085245
3252,漳,水,14,10,1200721,0.00082852,99.48168097
3253,聾,耳,22,10,1200731,0.00082852,99.48250949
3254,摹,手,15,10,1200741,0.00082852,99.48333801
3255,攘,手,20,10,1200751,0.00082852,99.48416653
3256,銜,金,14,10,1200761,0.00082852,99.48499505
3257,貘,豸,18,10,1200771,0.00082852,99.48582357
3258,瘡,ば,15,10,1200781,0.00082852,99.48665209
3259,喵,口,12,10,1200791,0.00082852,99.48748061
3260,磊,石,15,10,1200801,0.00082852,99.48830913
3261,哞,口,9,10,1200811,0.00082852,99.48913765
3262,薛,艸,17,10,1200821,0.00082852,99.48996617
3263,孢,子,8,10,1200831,0.00082852,99.49079469
3264,嚐,口,17,10,1200841,0.00082852,99.49162321
3265,璇,玉,15,10,1200851,0.00082852,99.49245173
3266,漱,水,14,10,1200861,0.00082852,99.49328025
3267,璀,玉,15,10,1200871,0.00082852,99.49410877
3268,嘈,口,14,10,1200881,0.00082852,99.49493729
3269,鈸,金,13,10,1200891,0.00082852,99.49576581
3270,詮,言,13,10,1200901,0.00082852,99.49659433
3271,撰,手,15,10,1200911,0.00082852,99.49742285
3272,蓓,艸,14,10,1200921,0.00082852,99.49825137
3273,鳶,鳥,14,10,1200931,0.00082852,99.49907989
3274,膩,肉,16,10,1200941,0.00082852,99.49990841
3275,癒,ば,18,10,1200951,0.00082852,99.50073693
3276,遴,ひ,16,10,1200961,0.00082852,99.50156545
3277,滌,水,14,10,1200971,0.00082852,99.50239397
3278,戍,戈,6,9,1200980,0.00074566,99.50313963
3279,狡,犬,9,9,1200989,0.00074566,99.50388529
3280,弘,弓,5,9,1200998,0.00074566,99.50463095
3281,呻,口,8,9,1201007,0.00074566,99.50537661
3282,帖,巾,8,9,1201016,0.00074566,99.50612227
3283,灼,火,7,9,1201025,0.00074566,99.50686793
3284,佗,人,7,9,1201034,0.00074566,99.50761359
3285,垮,土,9,9,1201043,0.00074566,99.50835925
3286,籽,米,9,9,1201052,0.00074566,99.50910491
3287,枸,木,9,9,1201061,0.00074566,99.50985057
3288,俐,人,9,9,1201070,0.00074566,99.51059623
3289,柿,木,9,9,1201079,0.00074566,99.51134189
3290,芙,艸,8,9,1201088,0.00074566,99.51208755
3291,餚,食,16,9,1201097,0.00074566,99.51283321
3292,諱,言,16,9,1201106,0.00074566,99.51357887
3293,咯,口,9,9,1201115,0.00074566,99.51432453
3294,鰍,魚,20,9,1201124,0.00074566,99.51507019
3295,玟,玉,8,9,1201133,0.00074566,99.51581585
3296,邏,ひ,23,9,1201142,0.00074566,99.51656151
3297,祠,示,10,9,1201151,0.00074566,99.51730717
3298,麓,鹿,19,9,1201160,0.00074566,99.51805283
3299,哽,口,10,9,1201169,0.00074566,99.51879849
3300,鐲,金,21,9,1201178,0.00074566,99.51954415
3301,梵,木,11,9,1201187,0.00074566,99.52028981
3302,曠,日,19,9,1201196,0.00074566,99.52103547
3303,蛀,虫,11,9,1201205,0.00074566,99.52178113
3304,儸,人,21,9,1201214,0.00074566,99.52252679
3305,淪,水,11,9,1201223,0.00074566,99.52327245
3306,襖,衣,19,9,1201232,0.00074566,99.52401811
3307,惋,心,11,9,1201241,0.00074566,99.52476377
3308,瓏,玉,20,9,1201250,0.00074566,99.52550943
3309,煥,火,13,9,1201259,0.00074566,99.52625509
3310,韁,革,22,9,1201268,0.00074566,99.52700075
3311,嗓,口,13,9,1201277,0.00074566,99.52774641
3312,瀚,水,19,9,1201286,0.00074566,99.52849207
3313,蛟,虫,12,9,1201295,0.00074566,99.52923773
3314,蜍,虫,13,9,1201304,0.00074566,99.52998339
3315,跋,足,12,9,1201313,0.00074566,99.53072905
3316,郯,邑,11,9,1201322,0.00074566,99.53147471
3317,毽,毛,13,9,1201331,0.00074566,99.53222037
3318,轆,車,18,9,1201340,0.00074566,99.53296603
3319,詭,言,13,9,1201349,0.00074566,99.53371169
3320,搨,手,13,9,1201358,0.00074566,99.53445735
3321,腱,肉,13,9,1201367,0.00074566,99.53520301
3322,繇,糸,17,9,1201376,0.00074566,99.53594867
3323,肇,聿,14,9,1201385,0.00074566,99.53669433
3324,鴞,鳥,16,9,1201394,0.00074566,99.53743999
3325,綵,糸,14,9,1201403,0.00074566,99.53818565
3326,茸,艸,10,9,1201412,0.00074566,99.53893131
3327,舐,舌,10,9,1201421,0.00074566,99.53967697
3328,摯,手,15,9,1201430,0.00074566,99.54042263
3329,缽,缶,11,9,1201439,0.00074566,99.54116829
3330,裸,衣,14,9,1201448,0.00074566,99.54191395
3331,崔,山,11,9,1201457,0.00074566,99.54265961
3332,嘯,口,15,9,1201466,0.00074566,99.54340527
3333,屜,尸,11,9,1201475,0.00074566,99.54415093
3334,餃,食,14,9,1201484,0.00074566,99.54489659
3335,絆,糸,11,9,1201493,0.00074566,99.54564225
3336,矯,矢,17,9,1201502,0.00074566,99.54638791
3337,湍,水,12,9,1201511,0.00074566,99.54713357
3338,濺,水,18,9,1201520,0.00074566,99.54787923
3339,鈉,金,12,9,1201529,0.00074566,99.54862489
3340,衫,衣,9,9,1201538,0.00074566,99.54937055
3341,氯,气,12,9,1201547,0.00074566,99.55011621
3342,輟,車,15,9,1201556,0.00074566,99.55086187
3343,椒,木,12,9,1201565,0.00074566,99.55160753
3344,瞌,目,15,9,1201574,0.00074566,99.55235319
3345,痘,ば,12,9,1201583,0.00074566,99.55309885
3346,蕃,艸,16,9,1201592,0.00074566,99.55384451
3347,擄,手,16,9,1201601,0.00074566,99.55459017
3348,褚,衣,14,9,1201610,0.00074566,99.55533583
3349,羲,羊,16,9,1201619,0.00074566,99.55608149
3350,迭,ひ,9,9,1201628,0.00074566,99.55682715
3351,虞,虍,13,9,1201637,0.00074566,99.55757281
3352,屢,尸,14,9,1201646,0.00074566,99.55831847
3353,嗽,口,14,9,1201655,0.00074566,99.55906413
3354,禎,示,14,9,1201664,0.00074566,99.55980979
3355,霉,雨,15,9,1201673,0.00074566,99.56055545
3356,匕,匕,2,8,1201681,0.00066281,99.56121826
3357,阱,阜,7,8,1201689,0.00066281,99.56188107
3358,灶,火,7,8,1201697,0.00066281,99.56254388
3359,甩,用,5,8,1201705,0.00066281,99.56320669
3360,吭,口,7,8,1201713,0.00066281,99.56386950
3361,扒,手,5,8,1201721,0.00066281,99.56453231
3362,妍,女,7,8,1201729,0.00066281,99.56519512
3363,扛,手,6,8,1201737,0.00066281,99.56585793
3364,苟,艸,9,8,1201745,0.00066281,99.56652074
3365,刃,刀,3,8,1201753,0.00066281,99.56718355
3366,肱,肉,8,8,1201761,0.00066281,99.56784636
3367,毋,毋,4,8,1201769,0.00066281,99.56850917
3368,竽,竹,9,8,1201777,0.00066281,99.56917198
3369,肛,肉,7,8,1201785,0.00066281,99.56983479
3370,咧,口,9,8,1201793,0.00066281,99.57049760
3371,佐,人,7,8,1201801,0.00066281,99.57116041
3372,胄,肉,9,8,1201809,0.00066281,99.57182322
3373,亢,ぞ,4,8,1201817,0.00066281,99.57248603
3374,柵,木,9,8,1201825,0.00066281,99.57314884
3375,几,几,2,8,1201833,0.00066281,99.57381165
3376,唧,口,10,8,1201841,0.00066281,99.57447446
3377,甸,田,7,8,1201849,0.00066281,99.57513727
3378,夸,大,6,8,1201857,0.00066281,99.57580008
3379,冉,た,5,8,1201865,0.00066281,99.57646289
3380,卞,卜,4,8,1201873,0.00066281,99.57712570
3381,卒,十,8,8,1201881,0.00066281,99.57778851
3382,疹,ば,10,8,1201889,0.00066281,99.57845132
3383,茹,艸,10,8,1201897,0.00066281,99.57911413
3384,叟,又,10,8,1201905,0.00066281,99.57977694
3385,蚤,虫,10,8,1201913,0.00066281,99.58043975
3386,逞,ひ,11,8,1201921,0.00066281,99.58110256
3387,揣,手,12,8,1201929,0.00066281,99.58176537
3388,麝,鹿,21,8,1201937,0.00066281,99.58242818
3389,廬,な,19,8,1201945,0.00066281,99.58309099
3390,釵,金,11,8,1201953,0.00066281,99.58375380
3391,鐸,金,21,8,1201961,0.00066281,99.58441661
3392,搏,手,13,8,1201969,0.00066281,99.58507942
3393,黯,黑,21,8,1201977,0.00066281,99.58574223
3394,嗜,口,13,8,1201985,0.00066281,99.58640504
3395,繚,糸,18,8,1201993,0.00066281,99.58706785
3396,馮,馬,12,8,1202001,0.00066281,99.58773066
3397,鞣,革,18,8,1202009,0.00066281,99.58839347
3398,甦,生,12,8,1202017,0.00066281,99.58905628
3399,鐮,金,21,8,1202025,0.00066281,99.58971909
3400,楞,木,13,8,1202033,0.00066281,99.59038190
3401,纔,糸,23,8,1202041,0.00066281,99.59104471
3402,綸,糸,14,8,1202049,0.00066281,99.59170752
3403,饑,食,20,8,1202057,0.00066281,99.59237033
3404,寨,で,14,8,1202065,0.00066281,99.59303314
3405,掂,手,11,8,1202073,0.00066281,99.59369595
3406,滷,水,14,8,1202081,0.00066281,99.59435876
3407,纍,糸,21,8,1202089,0.00066281,99.59502157
3408,廓,な,14,8,1202097,0.00066281,99.59568438
3409,尪,尢,7,8,1202105,0.00066281,99.59634719
3410,憫,心,15,8,1202113,0.00066281,99.59701000
3411,鰹,魚,22,8,1202121,0.00066281,99.59767281
3412,磅,石,15,8,1202129,0.00066281,99.59833562
3413,楂,木,13,8,1202137,0.00066281,99.59899843
3414,鄱,邑,15,8,1202145,0.00066281,99.59966124
3415,恒,心,9,8,1202153,0.00066281,99.60032405
3416,蝗,虫,15,8,1202161,0.00066281,99.60098686
3417,髖,骨,25,8,1202169,0.00066281,99.60164967
3418,斃,の,17,8,1202177,0.00066281,99.60231248
3419,矚,目,26,8,1202185,0.00066281,99.60297529
3420,霍,雨,16,8,1202193,0.00066281,99.60363810
3421,掀,手,11,8,1202201,0.00066281,99.60430091
3422,褲,衣,16,8,1202209,0.00066281,99.60496372
3423,皓,白,12,8,1202217,0.00066281,99.60562653
3424,櫛,木,17,8,1202225,0.00066281,99.60628934
3425,渺,水,12,8,1202233,0.00066281,99.60695215
3426,頤,頁,16,8,1202241,0.00066281,99.60761496
3427,貸,貝,12,8,1202249,0.00066281,99.60827777
3428,簍,竹,17,8,1202257,0.00066281,99.60894058
3429,貶,貝,12,8,1202265,0.00066281,99.60960339
3430,臀,肉,17,8,1202273,0.00066281,99.61026620
3431,瑙,玉,13,8,1202281,0.00066281,99.61092901
3432,羹,羊,19,8,1202289,0.00066281,99.61159182
3433,嶇,山,14,8,1202297,0.00066281,99.61225463
3434,朧,月,20,8,1202305,0.00066281,99.61291744
3435,蓆,艸,14,8,1202313,0.00066281,99.61358025
3436,琍,玉,11,8,1202321,0.00066281,99.61424306
3437,瑛,玉,13,8,1202329,0.00066281,99.61490587
3438,趨,走,17,8,1202337,0.00066281,99.61556868
3439,僵,人,15,8,1202345,0.00066281,99.61623149
3440,諺,言,16,8,1202353,0.00066281,99.61689430
3441,閥,門,14,8,1202361,0.00066281,99.61755711
3442,癟,ば,19,8,1202369,0.00066281,99.61821992
3443,繆,糸,17,8,1202377,0.00066281,99.61888273
3444,隸,び,17,8,1202385,0.00066281,99.61954554
3445,褶,衣,17,8,1202393,0.00066281,99.62020835
3446,攏,手,19,8,1202401,0.00066281,99.62087116
3447,駁,馬,14,8,1202409,0.00066281,99.62153397
3448,撼,手,16,8,1202417,0.00066281,99.62219678
3449,鞍,革,15,8,1202425,0.00066281,99.62285959
3450,踱,足,16,8,1202433,0.00066281,99.62352240
3451,朦,月,18,8,1202441,0.00066281,99.62418521
3452,汐,水,6,7,1202448,0.00057996,99.62476517
3453,苞,艸,9,7,1202455,0.00057996,99.62534513
3455,峪,山,10,7,1202469,0.00057996,99.62650505
3456,厄,厂,4,7,1202476,0.00057996,99.62708501
3457,桅,木,10,7,1202483,0.00057996,99.62766497
3458,臼,臼,6,7,1202490,0.00057996,99.62824493
3459,浙,水,10,7,1202497,0.00057996,99.62882489
3460,兀,儿,3,7,1202504,0.00057996,99.62940485
3461,陝,阜,10,7,1202511,0.00057996,99.62998481
3462,玖,玉,7,7,1202518,0.00057996,99.63056477
3463,豺,豸,10,7,1202525,0.00057996,99.63114473
3464,歧,止,8,7,1202532,0.00057996,99.63172469
3465,蚜,虫,10,7,1202539,0.00057996,99.63230465
3466,姚,女,9,7,1202546,0.00057996,99.63288461
3467,舀,臼,10,7,1202553,0.00057996,99.63346457
3468,俘,人,9,7,1202560,0.00057996,99.63404453
3469,梓,木,11,7,1202567,0.00057996,99.63462449
3471,愕,心,12,7,1202581,0.00057996,99.63578441
3472,卦,卜,8,7,1202588,0.00057996,99.63636437
3473,厥,厂,12,7,1202595,0.00057996,99.63694433
3474,炯,火,9,7,1202602,0.00057996,99.63752429
3475,妄,女,6,7,1202609,0.00057996,99.63810425
3476,吋,口,6,7,1202616,0.00057996,99.63868421
3477,扼,手,7,7,1202623,0.00057996,99.63926417
3478,柑,木,9,7,1202630,0.00057996,99.63984413
3479,彪,虍,11,7,1202637,0.00057996,99.64042409
3480,莒,艸,11,7,1202644,0.00057996,99.64100405
3481,荼,艸,11,7,1202651,0.00057996,99.64158401
3482,瑯,玉,13,7,1202658,0.00057996,99.64216397
3483,滄,水,13,7,1202665,0.00057996,99.64274393
3484,瀏,水,18,7,1202672,0.00057996,99.64332389
3485,犄,牛,12,7,1202679,0.00057996,99.64390385
3486,檀,木,17,7,1202686,0.00057996,99.64448381
3487,跛,足,12,7,1202693,0.00057996,99.64506377
3488,嚎,口,17,7,1202700,0.00057996,99.64564373
3489,剷,刀,13,7,1202707,0.00057996,99.64622369
3490,甕,瓦,18,7,1202714,0.00057996,99.64680365
3491,漬,水,14,7,1202721,0.00057996,99.64738361
3492,褪,衣,16,7,1202728,0.00057996,99.64796357
3493,蜷,虫,14,7,1202735,0.00057996,99.64854353
3494,蘑,艸,20,7,1202742,0.00057996,99.64912349
3495,嘖,口,14,7,1202749,0.00057996,99.64970345
3496,蠕,虫,20,7,1202756,0.00057996,99.65028341
3497,舔,舌,14,7,1202763,0.00057996,99.65086337
3498,蹺,足,19,7,1202770,0.00057996,99.65144333
3499,漓,水,14,7,1202777,0.00057996,99.65202329
3500,臏,肉,18,7,1202784,0.00057996,99.65260325
3501,硼,石,13,7,1202791,0.00057996,99.65318321
3502,鬢,髟,24,7,1202798,0.00057996,99.65376317
3503,餒,食,15,7,1202805,0.00057996,99.65434313
3504,藷,艸,19,7,1202812,0.00057996,99.65492309
3505,瑾,玉,15,7,1202819,0.00057996,99.65550305
3506,曦,日,20,7,1202826,0.00057996,99.65608301
3507,蟑,虫,17,7,1202833,0.00057996,99.65666297
3508,隴,阜,19,7,1202840,0.00057996,99.65724293
3509,煦,火,13,7,1202847,0.00057996,99.65782289
3510,鄲,邑,15,7,1202854,0.00057996,99.65840285
3511,膈,肉,14,7,1202861,0.00057996,99.65898281
3513,熙,火,14,7,1202875,0.00057996,99.66014273
3514,覷,見,19,7,1202882,0.00057996,99.66072269
3515,粱,米,13,7,1202889,0.00057996,99.66130265
3517,誣,言,14,7,1202903,0.00057996,99.66246257
3518,蹧,足,18,7,1202910,0.00057996,99.66304253
3519,猾,犬,13,7,1202917,0.00057996,99.66362249
3520,箍,竹,14,7,1202924,0.00057996,99.66420245
3521,嘔,口,14,7,1202931,0.00057996,99.66478241
3522,歎,欠,15,7,1202938,0.00057996,99.66536237
3523,憩,心,16,7,1202945,0.00057996,99.66594233
3524,蛹,虫,13,7,1202952,0.00057996,99.66652229
3525,幔,巾,14,7,1202959,0.00057996,99.66710225
3526,邯,邑,8,7,1202966,0.00057996,99.66768221
3527,螯,虫,17,7,1202973,0.00057996,99.66826217
3529,云,二,4,6,1202985,0.00049711,99.66925639
3530,佇,人,7,6,1202991,0.00049711,99.66975350
3531,旭,日,6,6,1202997,0.00049711,99.67025061
3532,倖,人,10,6,1203003,0.00049711,99.67074772
3533,桓,木,10,6,1203009,0.00049711,99.67124483
3534,沌,水,7,6,1203015,0.00049711,99.67174194
3535,勘,力,11,6,1203021,0.00049711,99.67223905
3536,帛,巾,8,6,1203027,0.00049711,99.67273616
3537,悍,心,10,6,1203033,0.00049711,99.67323327
3538,奄,大,8,6,1203039,0.00049711,99.67373038
3539,茵,艸,10,6,1203045,0.00049711,99.67422749
3540,矣,矢,7,6,1203051,0.00049711,99.67472460
3541,哮,口,10,6,1203057,0.00049711,99.67522171
3542,拐,手,8,6,1203063,0.00049711,99.67571882
3543,晁,日,10,6,1203069,0.00049711,99.67621593
3544,拴,手,9,6,1203075,0.00049711,99.67671304
3545,涕,水,10,6,1203081,0.00049711,99.67721015
3546,恬,心,9,6,1203087,0.00049711,99.67770726
3547,娓,女,10,6,1203093,0.00049711,99.67820437
3548,姦,女,9,6,1203099,0.00049711,99.67870148
3549,厝,厂,10,6,1203105,0.00049711,99.67919859
3550,穹,穴,8,6,1203111,0.00049711,99.67969570
3551,荔,艸,10,6,1203117,0.00049711,99.68019281
3552,矽,石,8,6,1203123,0.00049711,99.68068992
3553,倭,人,10,6,1203129,0.00049711,99.68118703
3554,婢,女,11,6,1203135,0.00049711,99.68168414
3555,挪,手,10,6,1203141,0.00049711,99.68218125
3556,矢,矢,5,6,1203147,0.00049711,99.68267836
3557,媧,女,12,6,1203153,0.00049711,99.68317547
3558,佰,人,8,6,1203159,0.00049711,99.68367258
3559,悴,心,11,6,1203165,0.00049711,99.68416969
3560,庇,な,7,6,1203171,0.00049711,99.68466680
3561,逕,ひ,11,6,1203177,0.00049711,99.68516391
3562,芯,艸,8,6,1203183,0.00049711,99.68566102
3563,淙,水,11,6,1203189,0.00049711,99.68615813
3564,剃,刀,9,6,1203195,0.00049711,99.68665524
3565,淫,水,11,6,1203201,0.00049711,99.68715235
3566,侷,人,9,6,1203207,0.00049711,99.68764946
3567,惕,心,11,6,1203213,0.00049711,99.68814657
3568,侈,人,8,6,1203219,0.00049711,99.68864368
3569,淆,水,11,6,1203225,0.00049711,99.68914079
3570,咆,口,8,6,1203231,0.00049711,99.68963790
3571,屎,尸,9,6,1203237,0.00049711,99.69013501
3572,郝,邑,10,6,1203243,0.00049711,99.69063212
3573,肘,肉,7,6,1203249,0.00049711,99.69112923
3574,柩,木,9,6,1203255,0.00049711,99.69162634
3575,揪,手,12,6,1203261,0.00049711,99.69212345
3576,犀,牛,12,6,1203267,0.00049711,99.69262056
3577,楨,木,13,6,1203273,0.00049711,99.69311767
3578,渲,水,12,6,1203279,0.00049711,99.69361478
3579,詐,言,12,6,1203285,0.00049711,99.69411189
3580,詔,言,12,6,1203291,0.00049711,99.69460900
3581,燻,火,18,6,1203297,0.00049711,99.69510611
3582,曜,日,18,6,1203303,0.00049711,99.69560322
3583,湛,水,12,6,1203309,0.00049711,99.69610033
3584,櫚,木,19,6,1203315,0.00049711,99.69659744
3585,痠,ば,12,6,1203321,0.00049711,99.69709455
3586,櫓,木,19,6,1203327,0.00049711,99.69759166
3587,搔,手,13,6,1203333,0.00049711,99.69808877
3588,臍,肉,18,6,1203339,0.00049711,99.69858588
3589,晷,日,12,6,1203345,0.00049711,99.69908299
3590,饗,食,21,6,1203351,0.00049711,99.69958010
3591,遁,ひ,13,6,1203357,0.00049711,99.70007721
3592,靂,雨,24,6,1203363,0.00049711,99.70057432
3593,綑,糸,13,6,1203369,0.00049711,99.70107143
3594,攬,手,24,6,1203375,0.00049711,99.70156854
3595,跺,足,13,6,1203381,0.00049711,99.70206565
3596,霹,雨,21,6,1203387,0.00049711,99.70256276
3597,萼,艸,13,6,1203393,0.00049711,99.70305987
3598,闐,門,18,6,1203399,0.00049711,99.70355698
3599,熒,火,14,6,1203405,0.00049711,99.70405409
3600,謬,言,18,6,1203411,0.00049711,99.70455120
3601,僥,人,14,6,1203417,0.00049711,99.70504831
3602,瀟,水,19,6,1203423,0.00049711,99.70554542
3603,撓,手,15,6,1203429,0.00049711,99.70604253
3604,薰,艸,18,6,1203435,0.00049711,99.70653964
3605,蔽,艸,15,6,1203441,0.00049711,99.70703675
3606,藩,艸,19,6,1203447,0.00049711,99.70753386
3607,締,糸,15,6,1203453,0.00049711,99.70803097
3608,瑄,玉,13,6,1203459,0.00049711,99.70852808
3609,緝,糸,15,6,1203465,0.00049711,99.70902519
3610,庄,な,6,6,1203471,0.00049711,99.70952230
3611,噬,口,16,6,1203477,0.00049711,99.71001941
3612,硅,石,11,6,1203483,0.00049711,99.71051652
3613,瞳,目,17,6,1203489,0.00049711,99.71101363
3614,嗝,口,13,6,1203495,0.00049711,99.71151074
3615,齋,齊,17,6,1203501,0.00049711,99.71200785
3616,黽,黽,13,6,1203507,0.00049711,99.71250496
3617,鎂,金,17,6,1203513,0.00049711,99.71300207
3618,祂,示,8,6,1203519,0.00049711,99.71349918
3619,頷,頁,16,6,1203525,0.00049711,99.71399629
3620,弇,廾,9,6,1203531,0.00049711,99.71449340
3621,熾,火,16,6,1203537,0.00049711,99.71499051
3622,鑾,金,27,6,1203543,0.00049711,99.71548762
3623,檯,木,18,6,1203549,0.00049711,99.71598473
3624,栖,木,10,6,1203555,0.00049711,99.71648184
3625,鮑,魚,16,6,1203561,0.00049711,99.71697895
3626,苡,艸,9,6,1203567,0.00049711,99.71747606
3627,蟒,虫,17,6,1203573,0.00049711,99.71797317
3628,嘓,口,14,6,1203579,0.00049711,99.71847028
3629,絞,糸,12,6,1203585,0.00049711,99.71896739
3630,漉,水,14,6,1203591,0.00049711,99.71946450
3631,楷,木,13,6,1203597,0.00049711,99.71996161
3632,樊,木,15,6,1203603,0.00049711,99.72045872
3633,噎,口,15,6,1203609,0.00049711,99.72095583
3634,鉗,金,13,6,1203615,0.00049711,99.72145294
3635,蹋,足,17,6,1203621,0.00049711,99.72195005
3636,祺,示,13,6,1203627,0.00049711,99.72244716
3637,霎,雨,16,6,1203633,0.00049711,99.72294427
3638,嗶,口,14,6,1203639,0.00049711,99.72344138
3639,篤,竹,16,6,1203645,0.00049711,99.72393849
3640,醋,酉,15,6,1203651,0.00049711,99.72443560
3641,駿,馬,17,6,1203657,0.00049711,99.72493271
3642,磋,石,15,6,1203663,0.00049711,99.72542982
3643,錠,金,16,6,1203669,0.00049711,99.72592693
3644,詣,言,13,6,1203675,0.00049711,99.72642404
3645,僱,人,14,6,1203681,0.00049711,99.72692115
3646,潺,水,15,6,1203687,0.00049711,99.72741826
3647,箔,竹,14,6,1203693,0.00049711,99.72791537
3648,閘,門,13,6,1203699,0.00049711,99.72841248
3649,諭,言,16,6,1203705,0.00049711,99.72890959
3650,諮,言,16,6,1203711,0.00049711,99.72940670
3651,蟆,虫,17,6,1203717,0.00049711,99.72990381
3652,痣,ば,12,6,1203723,0.00049711,99.73040092
3653,愾,心,13,6,1203729,0.00049711,99.73089803
3654,乓,ぜ,6,5,1203734,0.00041426,99.73131229
3655,孜,子,7,5,1203739,0.00041426,99.73172655
3656,拎,手,8,5,1203744,0.00041426,99.73214081
3657,乒,ぜ,6,5,1203749,0.00041426,99.73255507
3658,佣,人,7,5,1203754,0.00041426,99.73296933
3659,妤,女,7,5,1203759,0.00041426,99.73338359
3660,呃,口,7,5,1203764,0.00041426,99.73379785
3661,汲,水,7,5,1203769,0.00041426,99.73421211
3662,甫,用,7,5,1203774,0.00041426,99.73462637
3663,伽,人,7,5,1203779,0.00041426,99.73504063
3664,兌,儿,7,5,1203784,0.00041426,99.73545489
3665,囪,囗,7,5,1203789,0.00041426,99.73586915
3666,肪,肉,8,5,1203794,0.00041426,99.73628341
3667,剁,刀,8,5,1203799,0.00041426,99.73669767
3668,杵,木,8,5,1203804,0.00041426,99.73711193
3669,坍,土,7,5,1203809,0.00041426,99.73752619
3670,卅,十,4,5,1203814,0.00041426,99.73794045
3671,岔,山,7,5,1203819,0.00041426,99.73835471
3672,觔,角,9,5,1203824,0.00041426,99.73876897
3673,隹,隹,8,5,1203829,0.00041426,99.73918323
3674,枴,木,9,5,1203834,0.00041426,99.73959749
3675,疚,ば,8,5,1203839,0.00041426,99.74001175
3676,剌,刀,9,5,1203844,0.00041426,99.74042601
3677,邵,邑,8,5,1203849,0.00041426,99.74084027
3678,驛,馬,23,5,1203854,0.00041426,99.74125453
3679,哉,口,9,5,1203859,0.00041426,99.74166879
3680,壢,土,19,5,1203864,0.00041426,99.74208305
3681,匍,ぢ,9,5,1203869,0.00041426,99.74249731
3682,靨,面,23,5,1203874,0.00041426,99.74291157
3683,盹,目,9,5,1203879,0.00041426,99.74332583
3684,鯽,魚,18,5,1203884,0.00041426,99.74374009
3685,炫,火,9,5,1203889,0.00041426,99.74415435
3686,齣,齒,20,5,1203894,0.00041426,99.74456861
3687,峙,山,9,5,1203899,0.00041426,99.74498287
3688,齲,齒,24,5,1203904,0.00041426,99.74539713
3689,蚪,虫,10,5,1203909,0.00041426,99.74581139
3690,騾,馬,21,5,1203914,0.00041426,99.74622565
3691,埂,土,10,5,1203919,0.00041426,99.74663991
3692,藕,艸,19,5,1203924,0.00041426,99.74705417
3693,訌,言,10,5,1203929,0.00041426,99.74746843
3694,巔,山,22,5,1203934,0.00041426,99.74788269
3695,砥,石,10,5,1203939,0.00041426,99.74829695
3696,囓,口,24,5,1203944,0.00041426,99.74871121
3697,匾,っ,11,5,1203949,0.00041426,99.74912547
3698,戇,心,28,5,1203954,0.00041426,99.74953973
3699,胳,肉,10,5,1203959,0.00041426,99.74995399
3700,椏,木,12,5,1203964,0.00041426,99.75036825
3701,埤,土,11,5,1203969,0.00041426,99.75078251
3702,翊,羽,11,5,1203974,0.00041426,99.75119677
3703,荻,艸,11,5,1203979,0.00041426,99.75161103
3704,龕,龍,22,5,1203984,0.00041426,99.75202529
3705,毬,毛,11,5,1203989,0.00041426,99.75243955
3706,哆,口,9,5,1203994,0.00041426,99.75285381
3707,帷,巾,11,5,1203999,0.00041426,99.75326807
3708,箬,竹,15,5,1204004,0.00041426,99.75368233
3709,眸,目,11,5,1204009,0.00041426,99.75409659
3710,斌,文,12,5,1204014,0.00041426,99.75451085
3711,扈,戶,11,5,1204019,0.00041426,99.75492511
3712,噁,口,15,5,1204024,0.00041426,99.75533937
3713,烯,火,11,5,1204029,0.00041426,99.75575363
3714,芮,艸,8,5,1204034,0.00041426,99.75616789
3715,悵,心,11,5,1204039,0.00041426,99.75658215
3716,窸,穴,16,5,1204044,0.00041426,99.75699641
3717,蛤,虫,12,5,1204049,0.00041426,99.75741067
3718,窣,穴,13,5,1204054,0.00041426,99.75782493
3719,萸,艸,12,5,1204059,0.00041426,99.75823919
3720,沏,水,7,5,1204064,0.00041426,99.75865345
3721,逵,ひ,12,5,1204069,0.00041426,99.75906771
3722,蕁,艸,16,5,1204074,0.00041426,99.75948197
3723,皴,皮,12,5,1204079,0.00041426,99.75989623
3724,葳,艸,13,5,1204084,0.00041426,99.76031049
3725,萃,艸,12,5,1204089,0.00041426,99.76072475
3726,菖,艸,12,5,1204094,0.00041426,99.76113901
3727,琺,玉,12,5,1204099,0.00041426,99.76155327
3728,鵜,鳥,18,5,1204104,0.00041426,99.76196753
3729,鈾,金,13,5,1204109,0.00041426,99.76238179
3730,蟄,虫,17,5,1204114,0.00041426,99.76279605
3731,辟,辛,13,5,1204119,0.00041426,99.76321031
3732,楸,木,13,5,1204124,0.00041426,99.76362457
3733,僚,人,14,5,1204129,0.00041426,99.76403883
3734,鶘,鳥,20,5,1204134,0.00041426,99.76445309
3735,馱,馬,13,5,1204139,0.00041426,99.76486735
3736,鵰,鳥,19,5,1204144,0.00041426,99.76528161
3737,睬,目,13,5,1204149,0.00041426,99.76569587
3739,痰,ば,13,5,1204159,0.00041426,99.76652439
3740,矗,目,24,5,1204164,0.00041426,99.76693865
3741,嬴,女,16,5,1204169,0.00041426,99.76735291
3742,攙,手,20,5,1204174,0.00041426,99.76776717
3743,輒,車,14,5,1204179,0.00041426,99.76818143
3744,昱,日,9,5,1204184,0.00041426,99.76859569
3745,賑,貝,14,5,1204189,0.00041426,99.76900995
3746,邸,邑,8,5,1204194,0.00041426,99.76942421
3747,毆,殳,15,5,1204199,0.00041426,99.76983847
3748,疙,ば,8,5,1204204,0.00041426,99.77025273
3749,嫻,女,15,5,1204209,0.00041426,99.77066699
3750,肴,肉,8,5,1204214,0.00041426,99.77108125
3751,噗,口,15,5,1204219,0.00041426,99.77149551
3752,婁,女,11,5,1204224,0.00041426,99.77190977
3753,駭,馬,16,5,1204229,0.00041426,99.77232403
3754,朔,月,10,5,1204234,0.00041426,99.77273829
3755,斂,の,17,5,1204239,0.00041426,99.77315255
3756,笆,竹,10,5,1204244,0.00041426,99.77356681
3757,嚏,口,17,5,1204249,0.00041426,99.77398107
3758,氨,气,10,5,1204254,0.00041426,99.77439533
3759,壑,土,17,5,1204259,0.00041426,99.77480959
3760,紊,糸,10,5,1204264,0.00041426,99.77522385
3761,檜,木,17,5,1204269,0.00041426,99.77563811
3762,胱,肉,10,5,1204274,0.00041426,99.77605237
3763,竅,穴,18,5,1204279,0.00041426,99.77646663
3764,俺,人,10,5,1204284,0.00041426,99.77688089
3765,闌,門,17,5,1204289,0.00041426,99.77729515
3766,匐,ぢ,11,5,1204294,0.00041426,99.77770941
3767,邃,ひ,18,5,1204299,0.00041426,99.77812367
3768,彫,ね,11,5,1204304,0.00041426,99.77853793
3769,辮,糸,20,5,1204309,0.00041426,99.77895219
3770,淤,水,11,5,1204314,0.00041426,99.77936645
3771,礪,石,20,5,1204319,0.00041426,99.77978071
3772,掖,手,11,5,1204324,0.00041426,99.78019497
3773,擂,手,16,5,1204329,0.00041426,99.78060923
3774,尉,寸,11,5,1204334,0.00041426,99.78102349
3775,磕,石,15,5,1204339,0.00041426,99.78143775
3776,眷,目,11,5,1204344,0.00041426,99.78185201
3777,履,尸,15,5,1204349,0.00041426,99.78226627
3778,涸,水,11,5,1204354,0.00041426,99.78268053
3779,諳,言,16,5,1204359,0.00041426,99.78309479
3780,舷,舟,11,5,1204364,0.00041426,99.78350905
3781,檣,木,17,5,1204369,0.00041426,99.78392331
3782,飧,食,12,5,1204374,0.00041426,99.78433757
3783,簪,竹,18,5,1204379,0.00041426,99.78475183
3784,棣,木,12,5,1204384,0.00041426,99.78516609
3785,霽,雨,22,5,1204389,0.00041426,99.78558035
3786,絢,糸,12,5,1204394,0.00041426,99.78599461
3787,斕,文,21,5,1204399,0.00041426,99.78640887
3788,榔,木,13,5,1204404,0.00041426,99.78682313
3789,瘩,ば,15,5,1204409,0.00041426,99.78723739
3790,硝,石,12,5,1204414,0.00041426,99.78765165
3791,憔,心,15,5,1204419,0.00041426,99.78806591
3792,榭,木,14,5,1204424,0.00041426,99.78848017
3793,糙,米,17,5,1204429,0.00041426,99.78889443
3794,葆,艸,13,5,1204434,0.00041426,99.78930869
3795,鵪,鳥,19,5,1204439,0.00041426,99.78972295
3796,墟,土,15,5,1204444,0.00041426,99.79013721
3797,橈,木,16,5,1204449,0.00041426,99.79055147
3798,獷,犬,18,5,1204454,0.00041426,99.79096573
3799,釀,酉,24,5,1204459,0.00041426,99.79137999
3800,箸,竹,14,5,1204464,0.00041426,99.79179425
3801,瘧,ば,14,5,1204469,0.00041426,99.79220851
3802,蒞,艸,14,5,1204474,0.00041426,99.79262277
3803,痺,ば,13,5,1204479,0.00041426,99.79303703
3804,蝌,虫,15,5,1204484,0.00041426,99.79345129
3805,刁,刀,2,4,1204488,0.00033141,99.79378270
3806,唬,口,11,4,1204492,0.00033141,99.79411411
3807,仟,十,5,4,1204496,0.00033141,99.79444552
3808,陞,阜,10,4,1204500,0.00033141,99.79477693
3809,吆,口,6,4,1204504,0.00033141,99.79510834
3810,耙,耒,10,4,1204508,0.00033141,99.79543975
3811,夷,大,6,4,1204512,0.00033141,99.79577116
3812,狽,犬,10,4,1204516,0.00033141,99.79610257
3813,汝,水,6,4,1204520,0.00033141,99.79643398
3814,啕,口,11,4,1204524,0.00033141,99.79676539
3815,夭,大,4,4,1204528,0.00033141,99.79709680
3816,芻,艸,10,4,1204532,0.00033141,99.79742821
3817,呸,口,8,4,1204536,0.00033141,99.79775962
3818,蚌,虫,10,4,1204540,0.00033141,99.79809103
3819,匣,匚,7,4,1204544,0.00033141,99.79842244
3820,晌,日,10,4,1204548,0.00033141,99.79875385
3821,咎,口,8,4,1204552,0.00033141,99.79908526
3822,匿,っ,11,4,1204556,0.00033141,99.79941667
3823,侑,人,8,4,1204560,0.00033141,99.79974808
3824,迸,ひ,10,4,1204564,0.00033141,99.80007949
3825,邑,邑,7,4,1204568,0.00033141,99.80041090
3826,赦,赤,11,4,1204572,0.00033141,99.80074231
3827,咨,口,9,4,1204576,0.00033141,99.80107372
3828,悸,心,11,4,1204580,0.00033141,99.80140513
3829,祁,示,8,4,1204584,0.00033141,99.80173654
3830,赧,赤,11,4,1204588,0.00033141,99.80206795
3831,氟,气,9,4,1204592,0.00033141,99.80239936
3832,掬,手,11,4,1204596,0.00033141,99.80273077
3833,冑,た,9,4,1204600,0.00033141,99.80306218
3834,涎,水,11,4,1204604,0.00033141,99.80339359
3835,沮,水,8,4,1204608,0.00033141,99.80372500
3836,斛,斗,11,4,1204612,0.00033141,99.80405641
3837,泵,水,9,4,1204616,0.00033141,99.80438782
3838,悼,心,11,4,1204620,0.00033141,99.80471923
3839,匡,匚,6,4,1204624,0.00033141,99.80505064
3840,莢,艸,11,4,1204628,0.00033141,99.80538205
3841,聿,聿,6,4,1204632,0.00033141,99.80571346
3842,蛄,虫,11,4,1204636,0.00033141,99.80604487
3843,岱,山,8,4,1204640,0.00033141,99.80637628
3844,痊,ば,11,4,1204644,0.00033141,99.80670769
3845,岌,山,7,4,1204648,0.00033141,99.80703910
3846,舶,舟,11,4,1204652,0.00033141,99.80737051
3847,沂,水,7,4,1204656,0.00033141,99.80770192
3848,犁,牛,11,4,1204660,0.00033141,99.80803333
3849,炬,火,9,4,1204664,0.00033141,99.80836474
3850,惚,心,11,4,1204668,0.00033141,99.80869615
3851,芾,艸,8,4,1204672,0.00033141,99.80902756
3852,寐,で,12,4,1204676,0.00033141,99.80935897
3853,拷,手,9,4,1204680,0.00033141,99.80969038
3854,惦,心,11,4,1204684,0.00033141,99.81002179
3855,疋,疋,5,4,1204688,0.00033141,99.81035320
3856,庵,な,11,4,1204692,0.00033141,99.81068461
3857,庚,な,8,4,1204696,0.00033141,99.81101602
3858,湃,水,12,4,1204700,0.00033141,99.81134743
3859,沽,水,8,4,1204704,0.00033141,99.81167884
3860,嗦,口,13,4,1204708,0.00033141,99.81201025
3861,俞,人,9,4,1204712,0.00033141,99.81234166
3862,壬,士,4,4,1204716,0.00033141,99.81267307
3863,岐,山,7,4,1204720,0.00033141,99.81300448
3864,殃,歹,9,4,1204724,0.00033141,99.81333589
3865,悚,心,10,4,1204728,0.00033141,99.81366730
3866,硯,石,12,4,1204732,0.00033141,99.81399871
3867,琶,玉,12,4,1204736,0.00033141,99.81433012
3868,渠,水,12,4,1204740,0.00033141,99.81466153
3869,搾,手,13,4,1204744,0.00033141,99.81499294
3870,渤,水,12,4,1204748,0.00033141,99.81532435
3871,饞,食,25,4,1204752,0.00033141,99.81565576
3872,弒,弋,13,4,1204756,0.00033141,99.81598717
3873,洒,水,9,4,1204760,0.00033141,99.81631858
3874,粟,米,12,4,1204764,0.00033141,99.81664999
3875,蠵,虫,24,4,1204768,0.00033141,99.81698140
3876,榴,木,14,4,1204772,0.00033141,99.81731281
3877,鈺,金,13,4,1204776,0.00033141,99.81764422
3878,雉,隹,13,4,1204780,0.00033141,99.81797563
3879,獾,犬,21,4,1204784,0.00033141,99.81830704
3880,誅,言,13,4,1204788,0.00033141,99.81863845
3882,睦,目,13,4,1204796,0.00033141,99.81930127
3883,搥,手,13,4,1204800,0.00033141,99.81963268
3884,膊,肉,14,4,1204804,0.00033141,99.81996409
3885,饋,食,20,4,1204808,0.00033141,99.82029550
3886,踞,足,15,4,1204812,0.00033141,99.82062691
3887,嗒,口,13,4,1204816,0.00033141,99.82095832
3888,篆,竹,15,4,1204820,0.00033141,99.82128973
3889,煒,火,13,4,1204824,0.00033141,99.82162114
3890,踝,足,15,4,1204828,0.00033141,99.82195255
3891,澇,水,15,4,1204832,0.00033141,99.82228396
3892,撩,手,15,4,1204836,0.00033141,99.82261537
3893,鮒,魚,16,4,1204840,0.00033141,99.82294678
3894,瘟,ば,15,4,1204844,0.00033141,99.82327819
3895,鑷,金,26,4,1204848,0.00033141,99.82360960
3896,皚,白,15,4,1204852,0.00033141,99.82394101
3897,掐,手,11,4,1204856,0.00033141,99.82427242
3898,骷,骨,15,4,1204860,0.00033141,99.82460383
3899,笊,竹,10,4,1204864,0.00033141,99.82493524
3900,墮,土,15,4,1204868,0.00033141,99.82526665
3901,琇,玉,11,4,1204872,0.00033141,99.82559806
3902,墩,土,15,4,1204876,0.00033141,99.82592947
3903,鎏,金,17,4,1204880,0.00033141,99.82626088
3904,駙,馬,15,4,1204884,0.00033141,99.82659229
3905,戩,戈,14,4,1204888,0.00033141,99.82692370
3906,噩,口,16,4,1204892,0.00033141,99.82725511
3907,粘,米,11,4,1204896,0.00033141,99.82758652
3908,勳,力,16,4,1204900,0.00033141,99.82791793
3909,叡,又,16,4,1204904,0.00033141,99.82824934
3910,冀,八,16,4,1204908,0.00033141,99.82858075
3911,槐,木,14,4,1204912,0.00033141,99.82891216
3912,礡,石,22,4,1204916,0.00033141,99.82924357
3913,遏,ひ,13,4,1204920,0.00033141,99.82957498
3914,餡,食,16,4,1204924,0.00033141,99.82990639
3915,粹,米,14,4,1204928,0.00033141,99.83023780
3916,穢,禾,18,4,1204932,0.00033141,99.83056921
3917,睞,目,13,4,1204936,0.00033141,99.83090062
3918,篡,竹,16,4,1204940,0.00033141,99.83123203
3919,醇,酉,15,4,1204944,0.00033141,99.83156344
3920,檳,木,18,4,1204948,0.00033141,99.83189485
3921,熨,火,15,4,1204952,0.00033141,99.83222626
3922,艙,舟,16,4,1204956,0.00033141,99.83255767
3923,戮,戈,15,4,1204960,0.00033141,99.83288908
3924,繃,糸,17,4,1204964,0.00033141,99.83322049
3925,璋,玉,15,4,1204968,0.00033141,99.83355190
3926,謐,言,17,4,1204972,0.00033141,99.83388331
3927,瘠,ば,15,4,1204976,0.00033141,99.83421472
3928,篙,竹,16,4,1204980,0.00033141,99.83454613
3929,賬,貝,15,4,1204984,0.00033141,99.83487754
3930,澀,水,17,4,1204988,0.00033141,99.83520895
3931,嫵,女,15,4,1204992,0.00033141,99.83554036
3932,髏,骨,21,4,1204996,0.00033141,99.83587177
3933,擒,手,16,4,1205000,0.00033141,99.83620318
3934,鏘,金,19,4,1205004,0.00033141,99.83653459
3935,颯,風,14,4,1205008,0.00033141,99.83686600
3936,饅,食,19,4,1205012,0.00033141,99.83719741
3937,憊,心,16,4,1205016,0.00033141,99.83752882
3938,鎳,金,18,4,1205020,0.00033141,99.83786023
3939,噯,口,16,4,1205024,0.00033141,99.83819164
3940,醺,酉,21,4,1205028,0.00033141,99.83852305
3941,嘮,口,15,4,1205032,0.00033141,99.83885446
3942,囂,口,21,4,1205036,0.00033141,99.83918587
3943,駟,馬,15,4,1205040,0.00033141,99.83951728
3944,癩,ば,21,4,1205044,0.00033141,99.83984869
3945,螫,虫,17,4,1205048,0.00033141,99.84018010
3946,贖,貝,22,4,1205052,0.00033141,99.84051151
3947,薑,艸,17,4,1205056,0.00033141,99.84084292
3948,癱,ば,24,4,1205060,0.00033141,99.84117433
3949,虜,虍,13,4,1205064,0.00033141,99.84150574
3950,攫,手,23,4,1205068,0.00033141,99.84183715
3951,髻,髟,16,4,1205072,0.00033141,99.84216856
3952,鰾,魚,22,4,1205076,0.00033141,99.84249997
3953,蹂,足,16,4,1205080,0.00033141,99.84283138
3954,癲,ば,24,4,1205084,0.00033141,99.84316279
3955,鼾,鼻,17,4,1205088,0.00033141,99.84349420
3956,髂,骨,19,4,1205092,0.00033141,99.84382561
3957,霓,雨,16,4,1205096,0.00033141,99.84415702
3958,粲,米,13,4,1205100,0.00033141,99.84448843
3959,螻,虫,17,4,1205104,0.00033141,99.84481984
3960,垛,土,9,4,1205108,0.00033141,99.84515125
3961,嶽,山,17,4,1205112,0.00033141,99.84548266
3962,彘,ぬ,12,4,1205116,0.00033141,99.84581407
3963,縛,糸,16,4,1205120,0.00033141,99.84614548
3964,搐,手,13,4,1205124,0.00033141,99.84647689
3965,谿,谷,17,4,1205128,0.00033141,99.84680830
3966,鷲,鳥,23,4,1205132,0.00033141,99.84713971
3967,懦,心,17,4,1205136,0.00033141,99.84747112
3968,窘,穴,12,4,1205140,0.00033141,99.84780253
3969,轄,車,17,4,1205144,0.00033141,99.84813394
3970,鱉,魚,22,4,1205148,0.00033141,99.84846535
3971,鏢,金,19,4,1205152,0.00033141,99.84879676
3972,鸝,鳥,30,4,1205156,0.00033141,99.84912817
3973,鎊,金,18,4,1205160,0.00033141,99.84945958
3975,闔,門,18,4,1205168,0.00033141,99.85012240
3976,晟,日,10,4,1205172,0.00033141,99.85045381
3977,疇,田,19,4,1205176,0.00033141,99.85078522
3978,鼴,鼠,22,4,1205180,0.00033141,99.85111663
3979,忡,心,7,4,1205184,0.00033141,99.85144804
3980,佼,人,8,4,1205188,0.00033141,99.85177945
3981,椹,木,13,4,1205192,0.00033141,99.85211086
3982,鯰,魚,19,4,1205196,0.00033141,99.85244227
3983,曝,日,19,4,1205200,0.00033141,99.85277368
3984,璽,玉,19,4,1205204,0.00033141,99.85310509
3985,籮,竹,25,4,1205208,0.00033141,99.85343650
3986,巖,山,23,4,1205212,0.00033141,99.85376791
3987,鱖,魚,23,4,1205216,0.00033141,99.85409932
3988,戌,戈,6,3,1205219,0.00024855,99.85434787
3989,弩,弓,8,3,1205222,0.00024855,99.85459642
3990,么,ぜ,3,3,1205225,0.00024855,99.85484497
3991,杭,木,8,3,1205228,0.00024855,99.85509352
3993,忿,心,8,3,1205234,0.00024855,99.85559062
3995,汞,水,7,3,1205240,0.00024855,99.85608772
3996,圭,土,6,3,1205243,0.00024855,99.85633627
3997,侖,人,8,3,1205246,0.00024855,99.85658482
3998,牟,牛,6,3,1205249,0.00024855,99.85683337
3999,珀,玉,9,3,1205252,0.00024855,99.85708192
4000,叼,口,5,3,1205255,0.00024855,99.85733047
4001,疤,ば,9,3,1205258,0.00024855,99.85757902
4002,弛,弓,6,3,1205261,0.00024855,99.85782757
4003,玳,玉,9,3,1205264,0.00024855,99.85807612
4004,汶,水,7,3,1205267,0.00024855,99.85832467
4005,胛,肉,9,3,1205270,0.00024855,99.85857322
4006,拄,手,8,3,1205273,0.00024855,99.85882177
4007,恤,心,9,3,1205276,0.00024855,99.85907032
4008,汨,水,7,3,1205279,0.00024855,99.85931887
4009,胥,肉,9,3,1205282,0.00024855,99.85956742
4011,洮,水,9,3,1205288,0.00024855,99.86006452
4012,丰,｜,4,3,1205291,0.00024855,99.86031307
4013,炳,火,9,3,1205294,0.00024855,99.86056162
4014,尸,尸,3,3,1205297,0.00024855,99.86081017
4015,芥,艸,8,3,1205300,0.00024855,99.86105872
4016,坷,土,8,3,1205303,0.00024855,99.86130727
4017,殆,歹,9,3,1205306,0.00024855,99.86155582
4018,勺,ぢ,3,3,1205309,0.00024855,99.86180437
4019,夙,夕,6,3,1205312,0.00024855,99.86205292
4020,忪,心,7,3,1205315,0.00024855,99.86230147
4021,抉,手,7,3,1205318,0.00024855,99.86255002
4023,韭,韭,9,3,1205324,0.00024855,99.86304712
4024,宥,で,9,3,1205327,0.00024855,99.86329567
4025,栓,木,10,3,1205330,0.00024855,99.86354422
4026,釗,金,10,3,1205333,0.00024855,99.86379277
4027,祐,示,10,3,1205336,0.00024855,99.86404132
4028,尹,ぜ,4,3,1205339,0.00024855,99.86428987
4029,敖,の,11,3,1205342,0.00024855,99.86453842
4030,姬,女,10,3,1205345,0.00024855,99.86478697
4031,腑,肉,12,3,1205348,0.00024855,99.86503552
4032,倪,人,10,3,1205351,0.00024855,99.86528407
4033,斟,斗,13,3,1205354,0.00024855,99.86553262
4034,捎,手,10,3,1205357,0.00024855,99.86578117
4035,詁,言,12,3,1205360,0.00024855,99.86602972
4036,浦,水,10,3,1205363,0.00024855,99.86627827
4037,徬,彳,13,3,1205366,0.00024855,99.86652682
4038,蚵,虫,11,3,1205369,0.00024855,99.86677537
4039,粥,米,12,3,1205372,0.00024855,99.86702392
4040,莧,艸,11,3,1205375,0.00024855,99.86727247
4041,瑁,玉,13,3,1205378,0.00024855,99.86752102
4042,惺,心,12,3,1205381,0.00024855,99.86776957
4043,窖,穴,12,3,1205384,0.00024855,99.86801812
4044,徨,彳,12,3,1205387,0.00024855,99.86826667
4045,蛭,虫,12,3,1205390,0.00024855,99.86851522
4046,扉,戶,12,3,1205393,0.00024855,99.86876377
4047,斐,文,12,3,1205396,0.00024855,99.86901232
4048,俾,人,10,3,1205399,0.00024855,99.86926087
4049,毓,毋,13,3,1205402,0.00024855,99.86950942
4050,酗,酉,11,3,1205405,0.00024855,99.86975797
4051,滂,水,13,3,1205408,0.00024855,99.87000652
4052,袈,衣,11,3,1205411,0.00024855,99.87025507
4053,貂,豸,12,3,1205414,0.00024855,99.87050362
4054,窒,穴,11,3,1205417,0.00024855,99.87075217
4055,烊,火,10,3,1205420,0.00024855,99.87100072
4056,揆,手,12,3,1205423,0.00024855,99.87124927
4057,寅,で,11,3,1205426,0.00024855,99.87149782
4058,蚣,虫,10,3,1205429,0.00024855,99.87174637
4059,琛,玉,12,3,1205432,0.00024855,99.87199492
4060,琦,玉,12,3,1205435,0.00024855,99.87224347
4061,琥,玉,12,3,1205438,0.00024855,99.87249202
4062,鄂,邑,12,3,1205441,0.00024855,99.87274057
4063,瑕,玉,13,3,1205444,0.00024855,99.87298912
4064,羔,羊,10,3,1205447,0.00024855,99.87323767
4065,醞,酉,17,3,1205450,0.00024855,99.87348622
4066,鳩,鳥,13,3,1205453,0.00024855,99.87373477
4067,黝,黑,17,3,1205456,0.00024855,99.87398332
4068,褂,衣,14,3,1205459,0.00024855,99.87423187
4069,燄,火,16,3,1205462,0.00024855,99.87448042
4070,肄,聿,13,3,1205465,0.00024855,99.87472897
4071,嬪,女,17,3,1205468,0.00024855,99.87497752
4072,慵,心,14,3,1205471,0.00024855,99.87522607
4073,踵,足,16,3,1205474,0.00024855,99.87547462
4074,筵,竹,14,3,1205477,0.00024855,99.87572317
4075,韆,革,24,3,1205480,0.00024855,99.87597172
4076,嘀,口,14,3,1205483,0.00024855,99.87622027
4077,靄,雨,24,3,1205486,0.00024855,99.87646882
4078,綾,糸,14,3,1205489,0.00024855,99.87671737
4079,鞦,革,18,3,1205492,0.00024855,99.87696592
4080,裊,衣,13,3,1205495,0.00024855,99.87721447
4081,蹼,足,19,3,1205498,0.00024855,99.87746302
4082,斡,斗,14,3,1205501,0.00024855,99.87771157
4083,羈,网,24,3,1205504,0.00024855,99.87796012
4084,裴,衣,14,3,1205507,0.00024855,99.87820867
4085,鼬,鼠,18,3,1205510,0.00024855,99.87845722
4086,憧,心,15,3,1205513,0.00024855,99.87870577
4087,譚,言,19,3,1205516,0.00024855,99.87895432
4088,頡,頁,15,3,1205519,0.00024855,99.87920287
4089,籐,竹,21,3,1205522,0.00024855,99.87945142
4090,憬,心,15,3,1205525,0.00024855,99.87969997
4091,闕,門,18,3,1205528,0.00024855,99.87994852
4092,緬,糸,15,3,1205531,0.00024855,99.88019707
4093,懺,心,20,3,1205534,0.00024855,99.88044562
4094,閤,門,14,3,1205537,0.00024855,99.88069417
4095,麒,鹿,19,3,1205540,0.00024855,99.88094272
4096,銨,金,14,3,1205543,0.00024855,99.88119127
4097,攣,手,23,3,1205546,0.00024855,99.88143982
4098,醃,酉,15,3,1205549,0.00024855,99.88168837
4099,鑒,金,22,3,1205552,0.00024855,99.88193692
4100,獰,犬,17,3,1205555,0.00024855,99.88218547
4101,蘸,艸,23,3,1205558,0.00024855,99.88243402
4102,蕈,艸,16,3,1205561,0.00024855,99.88268257
4103,羶,羊,19,3,1205564,0.00024855,99.88293112
4104,鍬,金,17,3,1205567,0.00024855,99.88317967
4105,霾,雨,22,3,1205570,0.00024855,99.88342822
4106,膿,肉,17,3,1205573,0.00024855,99.88367677
4107,贓,貝,21,3,1205576,0.00024855,99.88392532
4108,癖,ば,18,3,1205579,0.00024855,99.88417387
4109,儼,人,22,3,1205582,0.00024855,99.88442242
4110,擷,手,18,3,1205585,0.00024855,99.88467097
4111,鯉,魚,18,3,1205588,0.00024855,99.88491952
4112,謗,言,17,3,1205591,0.00024855,99.88516807
4114,瀆,水,18,3,1205597,0.00024855,99.88566517
4115,謅,言,17,3,1205600,0.00024855,99.88591372
4116,氈,毛,17,3,1205603,0.00024855,99.88616227
4117,唰,口,11,3,1205606,0.00024855,99.88641082
4118,戳,戈,18,3,1205609,0.00024855,99.88665937
4119,体,人,7,3,1205612,0.00024855,99.88690792
4120,謁,言,16,3,1205615,0.00024855,99.88715647
4121,謳,言,18,3,1205618,0.00024855,99.88740502
4122,諼,言,16,3,1205621,0.00024855,99.88765357
4123,懃,心,16,3,1205624,0.00024855,99.88790212
4124,縐,糸,16,3,1205627,0.00024855,99.88815067
4125,鎌,金,18,3,1205630,0.00024855,99.88839922
4126,滬,水,14,3,1205633,0.00024855,99.88864777
4127,螽,虫,17,3,1205636,0.00024855,99.88889632
4128,腮,肉,13,3,1205639,0.00024855,99.88914487
4129,瀧,水,19,3,1205642,0.00024855,99.88939342
4130,僮,人,14,3,1205645,0.00024855,99.88964197
4131,隼,隹,10,3,1205648,0.00024855,99.88989052
4132,蜈,虫,13,3,1205651,0.00024855,99.89013907
4133,涂,水,10,3,1205654,0.00024855,99.89038762
4134,摻,手,14,3,1205657,0.00024855,99.89063617
4135,欸,欠,11,3,1205660,0.00024855,99.89088472
4136,寰,で,16,3,1205663,0.00024855,99.89113327
4137,譊,言,19,3,1205666,0.00024855,99.89138182
4138,膛,肉,15,3,1205669,0.00024855,99.89163037
4139,蹠,足,18,3,1205672,0.00024855,99.89187892
4140,鞏,革,15,3,1205675,0.00024855,99.89212747
4141,憨,心,16,3,1205678,0.00024855,99.89237602
4142,璦,玉,17,3,1205681,0.00024855,99.89262457
4143,驥,馬,26,3,1205684,0.00024855,99.89287312
4144,璣,玉,16,3,1205687,0.00024855,99.89312167
4145,吽,口,7,3,1205690,0.00024855,99.89337022
4146,瘸,ば,16,3,1205693,0.00024855,99.89361877
4147,猝,犬,11,3,1205696,0.00024855,99.89386732
4148,瞥,目,16,3,1205699,0.00024855,99.89411587
4149,魨,魚,15,3,1205702,0.00024855,99.89436442
4150,濘,水,17,3,1205705,0.00024855,99.89461297
4151,嚭,口,19,3,1205708,0.00024855,99.89486152
4152,曇,日,16,3,1205711,0.00024855,99.89511007
4153,昶,日,9,3,1205714,0.00024855,99.89535862
4154,燼,火,18,3,1205717,0.00024855,99.89560717
4155,鄯,邑,15,3,1205720,0.00024855,99.89585572
4156,瘍,ば,14,3,1205723,0.00024855,99.89610427
4157,飆,風,21,3,1205726,0.00024855,99.89635282
4158,稔,禾,13,3,1205729,0.00024855,99.89660137
4159,笵,竹,11,3,1205732,0.00024855,99.89684992
4160,裟,衣,13,3,1205735,0.00024855,99.89709847
4161,彧,ね,10,3,1205738,0.00024855,99.89734702
4162,廝,な,15,3,1205741,0.00024855,99.89759557
4163,鰲,魚,22,3,1205744,0.00024855,99.89784412
4164,燉,火,16,3,1205747,0.00024855,99.89809267
4165,姵,女,9,3,1205750,0.00024855,99.89834122
4166,璿,玉,18,3,1205753,0.00024855,99.89858977
4167,鬟,髟,23,3,1205756,0.00024855,99.89883832
4168,殯,歹,18,3,1205759,0.00024855,99.89908687
4169,鑫,金,24,3,1205762,0.00024855,99.89933542
4170,璟,玉,16,3,1205765,0.00024855,99.89958397
4171,躪,足,27,3,1205768,0.00024855,99.89983252
4172,詫,言,13,3,1205771,0.00024855,99.90008107
4173,顳,頁,27,3,1205774,0.00024855,99.90032962
4174,鋅,金,15,3,1205777,0.00024855,99.90057817
4175,傜,人,12,3,1205780,0.00024855,99.90082672
4176,懋,心,17,3,1205783,0.00024855,99.90107527
4177,寥,で,14,3,1205786,0.00024855,99.90132382
4178,懍,心,16,3,1205789,0.00024855,99.90157237
4179,瘴,ば,16,3,1205792,0.00024855,99.90182092
4180,騁,馬,17,3,1205795,0.00024855,99.90206947
4181,鐙,金,20,3,1205798,0.00024855,99.90231802
4182,怜,心,8,3,1205801,0.00024855,99.90256657
4183,宕,で,8,3,1205804,0.00024855,99.90281512
4184,芃,艸,7,3,1205807,0.00024855,99.90306367
4185,銥,金,14,3,1205810,0.00024855,99.90331222
4186,睫,目,13,3,1205813,0.00024855,99.90356077
4188,鴷,鳥,17,3,1205819,0.00024855,99.90405787
4189,琮,玉,12,3,1205822,0.00024855,99.90430642
4190,伎,人,6,3,1205825,0.00024855,99.90455497
4191,摁,手,13,3,1205828,0.00024855,99.90480352
4192,愔,心,12,3,1205831,0.00024855,99.90505207
4193,嗩,口,13,3,1205834,0.00024855,99.90530062
4194,蓁,艸,14,3,1205837,0.00024855,99.90554917
4195,圮,土,6,3,1205840,0.00024855,99.90579772
4196,漚,水,14,3,1205843,0.00024855,99.90604627
4197,跗,足,12,3,1205846,0.00024855,99.90629482
4198,汕,水,6,2,1205848,0.00016570,99.90646052
4200,戎,戈,6,2,1205852,0.00016570,99.90679192
4201,丕,一,5,2,1205854,0.00016570,99.90695762
4203,并,干,6,2,1205858,0.00016570,99.90728902
4207,帚,巾,8,2,1205866,0.00016570,99.90795182
4208,艮,艮,6,2,1205868,0.00016570,99.90811752
4209,拗,手,8,2,1205870,0.00016570,99.90828322
4211,呶,口,8,2,1205874,0.00016570,99.90861462
4212,糸,糸,6,2,1205876,0.00016570,99.90878032
4213,仆,人,4,2,1205878,0.00016570,99.90894602
4214,圳,土,6,2,1205880,0.00016570,99.90911172
4216,弔,弓,4,2,1205884,0.00016570,99.90944312
4217,佻,人,8,2,1205886,0.00016570,99.90960882
4218,怵,心,8,2,1205888,0.00016570,99.90977452
4219,佬,人,8,2,1205890,0.00016570,99.90994022
4220,戾,戶,8,2,1205892,0.00016570,99.91010592
4221,阮,阜,7,2,1205894,0.00016570,99.91027162
4222,帘,巾,8,2,1205896,0.00016570,99.91043732
4223,胤,肉,9,2,1205898,0.00016570,99.91060302
4224,昕,日,8,2,1205900,0.00016570,99.91076872
4225,芷,艸,8,2,1205902,0.00016570,99.91093442
4226,汰,水,7,2,1205904,0.00016570,99.91110012
4227,柢,木,9,2,1205906,0.00016570,99.91126582
4228,妞,女,7,2,1205908,0.00016570,99.91143152
4229,俑,人,9,2,1205910,0.00016570,99.91159722
4230,囤,囗,7,2,1205912,0.00016570,99.91176292
4231,剋,刀,9,2,1205914,0.00016570,99.91192862
4232,彤,ね,7,2,1205916,0.00016570,99.91209432
4233,拽,手,9,2,1205918,0.00016570,99.91226002
4234,芹,艸,8,2,1205920,0.00016570,99.91242572
4235,虱,虫,8,2,1205922,0.00016570,99.91259142
4236,軋,車,8,2,1205924,0.00016570,99.91275712
4237,恃,心,9,2,1205926,0.00016570,99.91292282
4238,盂,皿,8,2,1205928,0.00016570,99.91308852
4239,垠,土,9,2,1205930,0.00016570,99.91325422
4240,阜,阜,8,2,1205932,0.00016570,99.91341992
4241,赳,走,9,2,1205934,0.00016570,99.91358562
4242,尬,尢,7,2,1205936,0.00016570,99.91375132
4243,苯,艸,9,2,1205938,0.00016570,99.91391702
4244,汴,水,7,2,1205940,0.00016570,99.91408272
4245,炊,火,8,2,1205942,0.00016570,99.91424842
4246,禺,禸,9,2,1205944,0.00016570,99.91441412
4247,奎,大,9,2,1205946,0.00016570,99.91457982
4248,紉,糸,9,2,1205948,0.00016570,99.91474552
4249,氓,氏,8,2,1205950,0.00016570,99.91491122
4250,癸,ぱ,9,2,1205952,0.00016570,99.91507692
4251,舢,舟,9,2,1205954,0.00016570,99.91524262
4252,沁,水,7,2,1205956,0.00016570,99.91540832
4253,奐,大,9,2,1205958,0.00016570,99.91557402
4254,玷,玉,9,2,1205960,0.00016570,99.91573972
4255,酋,酉,9,2,1205962,0.00016570,99.91590542
4256,迥,ひ,9,2,1205964,0.00016570,99.91607112
4257,閂,門,9,2,1205966,0.00016570,99.91623682
4258,冇,一,4,2,1205968,0.00016570,99.91640252
4259,倌,人,10,2,1205970,0.00016570,99.91656822
4260,旻,日,8,2,1205972,0.00016570,99.91673392
4261,罟,网,10,2,1205974,0.00016570,99.91689962
4262,呯,口,8,2,1205976,0.00016570,99.91706532
4263,胭,肉,10,2,1205978,0.00016570,99.91723102
4264,椽,木,13,2,1205980,0.00016570,99.91739672
4265,捍,手,10,2,1205982,0.00016570,99.91756242
4266,侄,人,8,2,1205984,0.00016570,99.91772812
4267,恣,心,10,2,1205986,0.00016570,99.91789382
4268,町,田,7,2,1205988,0.00016570,99.91805952
4269,涅,水,10,2,1205990,0.00016570,99.91822522
4271,訕,言,10,2,1205994,0.00016570,99.91855662
4272,皤,白,17,2,1205996,0.00016570,99.91872232
4273,狷,犬,10,2,1205998,0.00016570,99.91888802
4275,紜,糸,10,2,1206002,0.00016570,99.91921942
4276,璐,玉,17,2,1206004,0.00016570,99.91938512
4277,啤,口,11,2,1206006,0.00016570,99.91955082
4278,謔,言,16,2,1206008,0.00016570,99.91971652
4279,倔,人,10,2,1206010,0.00016570,99.91988222
4280,踽,足,16,2,1206012,0.00016570,99.92004792
4281,埠,土,11,2,1206014,0.00016570,99.92021362
4282,蘞,艸,21,2,1206016,0.00016570,99.92037932
4283,桔,木,10,2,1206018,0.00016570,99.92054502
4284,蘦,艸,21,2,1206020,0.00016570,99.92071072
4285,悻,心,11,2,1206022,0.00016570,99.92087642
4286,蕎,艸,16,2,1206024,0.00016570,99.92104212
4287,孳,子,12,2,1206026,0.00016570,99.92120782
4288,鰈,魚,20,2,1206028,0.00016570,99.92137352
4289,喫,口,12,2,1206030,0.00016570,99.92153922
4290,葚,艸,13,2,1206032,0.00016570,99.92170492
4291,廄,な,12,2,1206034,0.00016570,99.92187062
4292,饌,食,20,2,1206036,0.00016570,99.92203632
4293,弼,弓,12,2,1206038,0.00016570,99.92220202
4294,糗,米,16,2,1206040,0.00016570,99.92236772
4295,舂,臼,11,2,1206042,0.00016570,99.92253342
4296,獼,犬,20,2,1206044,0.00016570,99.92269912
4297,粕,米,11,2,1206046,0.00016570,99.92286482
4298,蠑,虫,20,2,1206048,0.00016570,99.92303052
4299,掣,手,12,2,1206050,0.00016570,99.92319622
4300,蛸,虫,13,2,1206052,0.00016570,99.92336192
4301,翌,羽,11,2,1206054,0.00016570,99.92352762
4302,纜,糸,27,2,1206056,0.00016570,99.92369332
4303,涿,水,11,2,1206058,0.00016570,99.92385902
4304,粧,米,12,2,1206060,0.00016570,99.92402472
4305,蛉,虫,11,2,1206062,0.00016570,99.92419042
4306,銹,金,15,2,1206064,0.00016570,99.92435612
4307,筐,竹,12,2,1206066,0.00016570,99.92452182
4308,獒,犬,15,2,1206068,0.00016570,99.92468752
4309,楠,木,13,2,1206070,0.00016570,99.92485322
4310,欉,木,22,2,1206072,0.00016570,99.92501892
4311,証,言,12,2,1206074,0.00016570,99.92518462
4312,籗,竹,22,2,1206076,0.00016570,99.92535032
4313,榆,木,13,2,1206078,0.00016570,99.92551602
4314,噘,口,15,2,1206080,0.00016570,99.92568172
4315,萋,艸,12,2,1206082,0.00016570,99.92584742
4316,櫫,木,19,2,1206084,0.00016570,99.92601312
4317,慄,心,13,2,1206086,0.00016570,99.92617882
4318,蠃,虫,19,2,1206088,0.00016570,99.92634452
4319,跚,足,12,2,1206090,0.00016570,99.92651022
4320,榧,木,14,2,1206092,0.00016570,99.92667592
4321,嗆,口,13,2,1206094,0.00016570,99.92684162
4322,魆,鬼,15,2,1206096,0.00016570,99.92700732
4323,鈐,金,12,2,1206098,0.00016570,99.92717302
4324,餑,食,15,2,1206100,0.00016570,99.92733872
4325,湣,水,12,2,1206102,0.00016570,99.92750442
4326,鬈,髟,18,2,1206104,0.00016570,99.92767012
4327,隅,阜,12,2,1206106,0.00016570,99.92783582
4328,皸,皮,14,2,1206108,0.00016570,99.92800152
4329,揖,手,12,2,1206110,0.00016570,99.92816722
4330,鴽,鳥,17,2,1206112,0.00016570,99.92833292
4331,慇,心,14,2,1206114,0.00016570,99.92849862
4332,鍙,金,17,2,1206116,0.00016570,99.92866432
4333,煽,火,14,2,1206118,0.00016570,99.92883002
4334,葎,艸,13,2,1206120,0.00016570,99.92899572
4335,琿,玉,13,2,1206122,0.00016570,99.92916142
4336,鶇,鳥,19,2,1206124,0.00016570,99.92932712
4337,酪,酉,13,2,1206126,0.00016570,99.92949282
4338,槤,木,15,2,1206128,0.00016570,99.92965852
4339,蜆,虫,13,2,1206130,0.00016570,99.92982422
4340,緄,糸,14,2,1206132,0.00016570,99.92998992
4341,榻,木,14,2,1206134,0.00016570,99.93015562
4342,忤,心,7,2,1206136,0.00016570,99.93032132
4343,蜊,虫,13,2,1206138,0.00016570,99.93048702
4344,蒡,艸,14,2,1206140,0.00016570,99.93065272
4345,蒿,艸,14,2,1206142,0.00016570,99.93081842
4346,蒟,艸,14,2,1206144,0.00016570,99.93098412
4347,魷,魚,15,2,1206146,0.00016570,99.93114982
4348,鱒,魚,23,2,1206148,0.00016570,99.93131552
4349,儕,人,16,2,1206150,0.00016570,99.93148122
4350,蒴,艸,14,2,1206152,0.00016570,99.93164692
4351,緹,糸,15,2,1206154,0.00016570,99.93181262
4352,蒻,艸,14,2,1206156,0.00016570,99.93197832
4353,遨,ひ,15,2,1206158,0.00016570,99.93214402
4354,劄,竹,14,2,1206160,0.00016570,99.93230972
4355,誡,言,14,2,1206162,0.00016570,99.93247542
4356,廨,な,16,2,1206164,0.00016570,99.93264112
4357,諉,言,15,2,1206166,0.00016570,99.93280682
4358,韙,韋,18,2,1206168,0.00016570,99.93297252
4359,稼,禾,15,2,1206170,0.00016570,99.93313822
4360,蜾,虫,14,2,1206172,0.00016570,99.93330392
4361,諂,言,15,2,1206174,0.00016570,99.93346962
4362,懨,心,17,2,1206176,0.00016570,99.93363532
4363,噶,口,16,2,1206178,0.00016570,99.93380102
4364,薈,艸,17,2,1206180,0.00016570,99.93396672
4365,餌,食,14,2,1206182,0.00016570,99.93413242
4366,胺,肉,10,2,1206184,0.00016570,99.93429812
4367,獗,犬,15,2,1206186,0.00016570,99.93446382
4368,珩,玉,10,2,1206188,0.00016570,99.93462952
4369,嚅,口,17,2,1206190,0.00016570,99.93479522
4370,苳,艸,9,2,1206192,0.00016570,99.93496092
4371,輿,車,17,2,1206194,0.00016570,99.93512662
4372,茌,艸,9,2,1206196,0.00016570,99.93529232
4373,燬,火,17,2,1206198,0.00016570,99.93545802
4374,苹,艸,9,2,1206200,0.00016570,99.93562372
4375,褸,衣,17,2,1206202,0.00016570,99.93578942
4376,嵋,山,12,2,1206204,0.00016570,99.93595512
4377,鮪,魚,17,2,1206206,0.00016570,99.93612082
4378,眈,目,9,2,1206208,0.00016570,99.93628652
4379,穆,禾,16,2,1206210,0.00016570,99.93645222
4380,囟,囗,6,2,1206212,0.00016570,99.93661792
4381,靛,青,16,2,1206214,0.00016570,99.93678362
4382,珈,玉,9,2,1206216,0.00016570,99.93694932
4383,篦,竹,16,2,1206218,0.00016570,99.93711502
4384,枷,木,9,2,1206220,0.00016570,99.93728072
4385,瞻,目,18,2,1206222,0.00016570,99.93744642
4386,拏,手,9,2,1206224,0.00016570,99.93761212
4387,褥,衣,16,2,1206226,0.00016570,99.93777782
4388,祛,示,10,2,1206228,0.00016570,99.93794352
4389,諜,言,16,2,1206230,0.00016570,99.93810922
4390,鈦,金,12,2,1206232,0.00016570,99.93827492
4391,轡,車,22,2,1206234,0.00016570,99.93844062
4392,邳,邑,8,2,1206236,0.00016570,99.93860632
4393,躊,足,21,2,1206238,0.00016570,99.93877202
4394,亓,二,4,2,1206240,0.00016570,99.93893772
4395,殲,歹,21,2,1206242,0.00016570,99.93910342
4396,狒,犬,8,2,1206244,0.00016570,99.93926912
4397,蹙,足,18,2,1206246,0.00016570,99.93943482
4398,酌,酉,10,2,1206248,0.00016570,99.93960052
4399,懾,心,21,2,1206250,0.00016570,99.93976622
4400,耆,老,10,2,1206252,0.00016570,99.93993192
4401,贅,貝,18,2,1206254,0.00016570,99.94009762
4402,偌,人,11,2,1206256,0.00016570,99.94026332
4403,蹣,足,18,2,1206258,0.00016570,99.94042902
4404,舨,舟,10,2,1206260,0.00016570,99.94059472
4405,夔,て,21,2,1206262,0.00016570,99.94076042
4406,浥,水,10,2,1206264,0.00016570,99.94092612
4407,鷥,鳥,23,2,1206266,0.00016570,99.94109182
4408,浹,水,10,2,1206268,0.00016570,99.94125752
4409,鎗,金,18,2,1206270,0.00016570,99.94142322
4410,娩,女,10,2,1206272,0.00016570,99.94158892
4411,蹶,足,19,2,1206274,0.00016570,99.94175462
4412,唆,口,10,2,1206276,0.00016570,99.94192032
4413,矇,目,19,2,1206278,0.00016570,99.94208602
4414,奚,大,10,2,1206280,0.00016570,99.94225172
4415,鎬,金,18,2,1206282,0.00016570,99.94241742
4416,秣,禾,10,2,1206284,0.00016570,99.94258312
4417,簣,竹,18,2,1206286,0.00016570,99.94274882
4418,啜,口,11,2,1206288,0.00016570,99.94291452
4419,鎔,金,18,2,1206290,0.00016570,99.94308022
4420,涇,水,10,2,1206292,0.00016570,99.94324592
4421,臚,肉,20,2,1206294,0.00016570,99.94341162
4422,朕,月,10,2,1206296,0.00016570,99.94357732
4423,繹,糸,19,2,1206298,0.00016570,99.94374302
4424,惘,心,11,2,1206300,0.00016570,99.94390872
4425,鏤,金,19,2,1206302,0.00016570,99.94407442
4426,瓠,瓜,11,2,1206304,0.00016570,99.94424012
4427,椋,木,12,2,1206306,0.00016570,99.94440582
4428,疵,ば,11,2,1206308,0.00016570,99.94457152
4429,脛,肉,11,2,1206310,0.00016570,99.94473722
4430,崧,山,11,2,1206312,0.00016570,99.94490292
4431,旒,方,12,2,1206314,0.00016570,99.94506862
4432,梱,木,11,2,1206316,0.00016570,99.94523432
4433,瓞,瓜,10,2,1206318,0.00016570,99.94540002
4434,耜,耒,11,2,1206320,0.00016570,99.94556572
4435,軫,車,12,2,1206322,0.00016570,99.94573142
4436,猖,犬,11,2,1206324,0.00016570,99.94589712
4437,膾,肉,17,2,1206326,0.00016570,99.94606282
4438,翎,羽,11,2,1206328,0.00016570,99.94622852
4439,燠,火,17,2,1206330,0.00016570,99.94639422
4440,幀,巾,12,2,1206332,0.00016570,99.94655992
4441,螟,虫,16,2,1206334,0.00016570,99.94672562
4442,晤,日,11,2,1206336,0.00016570,99.94689132
4443,霏,雨,16,2,1206338,0.00016570,99.94705702
4444,暄,日,13,2,1206340,0.00016570,99.94722272
4445,翱,羽,16,2,1206342,0.00016570,99.94738842
4446,楔,木,13,2,1206344,0.00016570,99.94755412
4447,臻,至,16,2,1206346,0.00016570,99.94771982
4448,彙,ぬ,13,2,1206348,0.00016570,99.94788552
4449,瀛,水,19,2,1206350,0.00016570,99.94805122
4450,楹,木,13,2,1206352,0.00016570,99.94821692
4451,禳,示,22,2,1206354,0.00016570,99.94838262
4452,媲,女,13,2,1206356,0.00016570,99.94854832
4453,顥,頁,21,2,1206358,0.00016570,99.94871402
4454,棠,木,12,2,1206360,0.00016570,99.94887972
4455,譁,言,19,2,1206362,0.00016570,99.94904542
4456,塢,土,13,2,1206364,0.00016570,99.94921112
4457,囁,口,21,2,1206366,0.00016570,99.94937682
4458,琨,玉,12,2,1206368,0.00016570,99.94954252
4459,罌,缶,20,2,1206370,0.00016570,99.94970822
4460,痙,ば,12,2,1206372,0.00016570,99.94987392
4461,譎,言,19,2,1206374,0.00016570,99.95003962
4462,腋,肉,12,2,1206376,0.00016570,99.95020532
4463,餽,食,18,2,1206378,0.00016570,99.95037102
4464,腴,肉,12,2,1206380,0.00016570,99.95053672
4465,傕,人,12,2,1206382,0.00016570,99.95070242
4466,腓,肉,12,2,1206384,0.00016570,99.95086812
4467,紓,糸,10,2,1206386,0.00016570,99.95103382
4468,雹,雨,13,2,1206388,0.00016570,99.95119952
4469,睇,目,12,2,1206390,0.00016570,99.95136522
4470,軾,車,13,2,1206392,0.00016570,99.95153092
4471,擘,手,17,2,1206394,0.00016570,99.95169662
4472,槃,木,14,2,1206396,0.00016570,99.95186232
4473,簑,竹,16,2,1206398,0.00016570,99.95202802
4474,雋,隹,12,2,1206400,0.00016570,99.95219372
4475,豁,谷,17,2,1206402,0.00016570,99.95235942
4476,詰,言,13,2,1206404,0.00016570,99.95252512
4477,櫺,木,21,2,1206406,0.00016570,99.95269082
4478,榨,木,14,2,1206408,0.00016570,99.95285652
4479,贗,貝,22,2,1206410,0.00016570,99.95302222
4480,榛,木,14,2,1206412,0.00016570,99.95318792
4481,鱔,魚,23,2,1206414,0.00016570,99.95335362
4482,瘁,ば,13,2,1206416,0.00016570,99.95351932
4483,襤,衣,20,2,1206418,0.00016570,99.95368502
4484,銬,金,14,2,1206420,0.00016570,99.95385072
4485,氪,气,11,2,1206422,0.00016570,99.95401642
4486,嬋,女,15,2,1206424,0.00016570,99.95418212
4487,尷,尢,17,2,1206426,0.00016570,99.95434782
4488,蝨,虫,15,2,1206428,0.00016570,99.95451352
4489,簌,竹,17,2,1206430,0.00016570,99.95467922
4490,閨,門,14,2,1206432,0.00016570,99.95484492
4491,巍,山,21,2,1206434,0.00016570,99.95501062
4492,誹,言,15,2,1206436,0.00016570,99.95517632
4493,醴,酉,20,2,1206438,0.00016570,99.95534202
4494,碾,石,15,2,1206440,0.00016570,99.95550772
4495,寔,で,12,2,1206442,0.00016570,99.95567342
4496,蠡,虫,21,2,1206444,0.00016570,99.95583912
4497,躇,足,19,2,1206446,0.00016570,99.95600482
4498,瀾,水,20,2,1206448,0.00016570,99.95617052
4499,璜,玉,16,2,1206450,0.00016570,99.95633622
4500,銖,金,14,2,1206452,0.00016570,99.95650192
4501,羯,羊,15,2,1206454,0.00016570,99.95666762
4502,閡,門,14,2,1206456,0.00016570,99.95683332
4503,稷,禾,15,2,1206458,0.00016570,99.95699902
4504,暱,日,15,2,1206460,0.00016570,99.95716472
4506,兗,,9,1,1206462,0.00008285,99.95733042
4508,恪,心,9,1,1206464,0.00008285,99.95749612
4509,氐,氏,5,1,1206465,0.00008285,99.95757897
4510,沱,水,8,1,1206466,0.00008285,99.95766182
4511,汎,水,6,1,1206467,0.00008285,99.95774467
4512,泗,水,8,1,1206468,0.00008285,99.95782752
4513,刎,刀,6,1,1206469,0.00008285,99.95791037
4514,咫,口,9,1,1206470,0.00008285,99.95799322
4516,倣,人,10,1,1206472,0.00008285,99.95815892
4517,叱,口,5,1,1206473,0.00008285,99.95824177
4518,姣,女,9,1,1206474,0.00008285,99.95832462
4520,浬,水,10,1,1206476,0.00008285,99.95849032
4521,阡,阜,6,1,1206477,0.00008285,99.95857317
4522,啣,口,11,1,1206478,0.00008285,99.95865602
4523,朴,木,6,1,1206479,0.00008285,99.95873887
4524,悖,心,10,1,1206480,0.00008285,99.95882172
4526,挈,手,10,1,1206482,0.00008285,99.95898742
4527,弁,廾,5,1,1206483,0.00008285,99.95907027
4528,珞,玉,10,1,1206484,0.00008285,99.95915312
4530,皋,白,10,1,1206486,0.00008285,99.95931882
4532,奘,大,10,1,1206488,0.00008285,99.95948452
4533,佯,人,8,1,1206489,0.00008285,99.95956737
4534,倨,人,10,1,1206490,0.00008285,99.95965022
4535,抿,手,8,1,1206491,0.00008285,99.95973307
4536,倏,人,11,1,1206492,0.00008285,99.95981592
4537,枋,木,8,1,1206493,0.00008285,99.95989877
4538,冢,だ,10,1,1206494,0.00008285,99.95998162
4539,杓,木,7,1,1206495,0.00008285,99.96006447
4540,娉,女,10,1,1206496,0.00008285,99.96014732
4541,咋,口,8,1,1206497,0.00008285,99.96023017
4542,偃,人,11,1,1206498,0.00008285,99.96031302
4543,邢,邑,7,1,1206499,0.00008285,99.96039587
4544,窈,穴,10,1,1206500,0.00008285,99.96047872
4545,孚,子,7,1,1206501,0.00008285,99.96056157
4546,鬲,鬲,10,1,1206502,0.00008285,99.96064442
4547,芍,艸,7,1,1206503,0.00008285,99.96072727
4548,茴,艸,10,1,1206504,0.00008285,99.96081012
4549,圻,土,7,1,1206505,0.00008285,99.96089297
4550,茗,艸,10,1,1206506,0.00008285,99.96097582
4551,吮,口,7,1,1206507,0.00008285,99.96105867
4552,茨,艸,10,1,1206508,0.00008285,99.96114152
4553,刨,刀,7,1,1206509,0.00008285,99.96122437
4554,婪,女,11,1,1206510,0.00008285,99.96130722
4555,泠,水,8,1,1206511,0.00008285,99.96139007
4556,荃,艸,10,1,1206512,0.00008285,99.96147292
4557,苛,艸,9,1,1206513,0.00008285,99.96155577
4558,逅,ひ,10,1,1206514,0.00008285,99.96163862
4559,泯,水,8,1,1206515,0.00008285,99.96172147
4560,俸,人,10,1,1206516,0.00008285,99.96180432
4561,祉,示,9,1,1206517,0.00008285,99.96188717
4562,孰,子,11,1,1206518,0.00008285,99.96197002
4563,泅,水,8,1,1206519,0.00008285,99.96205287
4564,窕,穴,11,1,1206520,0.00008285,99.96213572
4565,洌,水,9,1,1206521,0.00008285,99.96221857
4566,旎,方,11,1,1206522,0.00008285,99.96230142
4567,虻,虫,9,1,1206523,0.00008285,99.96238427
4568,捩,手,11,1,1206524,0.00008285,99.96246712
4569,牴,牛,9,1,1206525,0.00008285,99.96254997
4570,晦,日,11,1,1206526,0.00008285,99.96263282
4571,疣,ば,9,1,1206527,0.00008285,99.96271567
4572,嵐,山,12,1,1206528,0.00008285,99.96279852
4573,洵,水,9,1,1206529,0.00008285,99.96288137
4574,蛆,虫,11,1,1206530,0.00008285,99.96296422
4575,柚,木,9,1,1206531,0.00008285,99.96304707
4576,蚶,虫,11,1,1206532,0.00008285,99.96312992
4578,釧,金,11,1,1206534,0.00008285,99.96329562
4580,捫,手,11,1,1206536,0.00008285,99.96346132
4582,愜,心,12,1,1206538,0.00008285,99.96362702
4583,仃,人,4,1,1206539,0.00008285,99.96370987
4584,硃,石,11,1,1206540,0.00008285,99.96379272
4585,乩,乙,6,1,1206541,0.00008285,99.96387557
4586,啻,口,12,1,1206542,0.00008285,99.96395842
4588,淌,水,11,1,1206544,0.00008285,99.96412412
4589,甬,用,7,1,1206545,0.00008285,99.96420697
4590,捱,手,11,1,1206546,0.00008285,99.96428982
4591,侃,人,8,1,1206547,0.00008285,99.96437267
4592,惻,心,12,1,1206548,0.00008285,99.96445552
4593,戕,戈,8,1,1206549,0.00008285,99.96453837
4594,絀,糸,11,1,1206550,0.00008285,99.96462122
4595,妓,女,7,1,1206551,0.00008285,99.96470407
4596,崛,山,11,1,1206552,0.00008285,99.96478692
4597,杳,木,8,1,1206553,0.00008285,99.96486977
4598,愎,心,12,1,1206554,0.00008285,99.96495262
4599,佃,人,7,1,1206555,0.00008285,99.96503547
4600,脯,肉,11,1,1206556,0.00008285,99.96511832
4601,羌,羊,8,1,1206557,0.00008285,99.96520117
4602,惇,心,11,1,1206558,0.00008285,99.96528402
4603,苧,艸,9,1,1206559,0.00008285,99.96536687
4604,訢,言,11,1,1206560,0.00008285,99.96544972
4605,泓,水,8,1,1206561,0.00008285,99.96553257
4606,笞,竹,11,1,1206562,0.00008285,99.96561542
4607,洱,水,9,1,1206563,0.00008285,99.96569827
4608,猙,犬,11,1,1206564,0.00008285,99.96578112
4609,柒,木,9,1,1206565,0.00008285,99.96586397
4610,笮,竹,11,1,1206566,0.00008285,99.96594682
4611,氖,气,6,1,1206567,0.00008285,99.96602967
4612,焊,火,11,1,1206568,0.00008285,99.96611252
4614,揩,手,12,1,1206570,0.00008285,99.96627822
4616,淄,水,11,1,1206572,0.00008285,99.96644392
4617,酉,酉,7,1,1206573,0.00008285,99.96652677
4618,恿,心,11,1,1206574,0.00008285,99.96660962
4619,沅,水,7,1,1206575,0.00008285,99.96669247
4620,崢,山,11,1,1206576,0.00008285,99.96677532
4621,昊,日,8,1,1206577,0.00008285,99.96685817
4622,訟,言,11,1,1206578,0.00008285,99.96694102
4623,酊,酉,9,1,1206579,0.00008285,99.96702387
4624,豉,豆,11,1,1206580,0.00008285,99.96710672
4625,亟,二,9,1,1206581,0.00008285,99.96718957
4626,堰,土,12,1,1206582,0.00008285,99.96727242
4628,揹,手,12,1,1206584,0.00008285,99.96743812
4630,棹,木,12,1,1206586,0.00008285,99.96760382
4631,攸,の,7,1,1206587,0.00008285,99.96768667
4632,嵩,山,13,1,1206588,0.00008285,99.96776952
4633,苓,艸,9,1,1206589,0.00008285,99.96785237
4634,幌,巾,13,1,1206590,0.00008285,99.96793522
4635,甭,用,9,1,1206591,0.00008285,99.96801807
4636,昀,日,8,1,1206592,0.00008285,99.96810092
4637,杼,木,8,1,1206593,0.00008285,99.96818377
4638,盅,皿,9,1,1206594,0.00008285,99.96826662
4640,痢,ば,12,1,1206596,0.00008285,99.96843232
4641,塭,口,13,1,1206597,0.00008285,99.96851517
4642,賁,貝,12,1,1206598,0.00008285,99.96859802
4643,軼,車,12,1,1206599,0.00008285,99.96868087
4644,溴,水,13,1,1206600,0.00008285,99.96876372
4645,幄,巾,12,1,1206601,0.00008285,99.96884657
4646,嗉,口,13,1,1206602,0.00008285,99.96892942
4647,湡,水,12,1,1206603,0.00008285,99.96901227
4648,搆,手,13,1,1206604,0.00008285,99.96909512
4649,碴,石,14,1,1206605,0.00008285,99.96917797
4650,菠,艸,12,1,1206606,0.00008285,99.96926082
4651,裱,衣,14,1,1206607,0.00008285,99.96934367
4652,煜,火,13,1,1206608,0.00008285,99.96942652
4653,淼,水,12,1,1206609,0.00008285,99.96950937
4654,隍,阜,12,1,1206610,0.00008285,99.96959222
4655,蜚,虫,14,1,1206611,0.00008285,99.96967507
4656,渭,水,12,1,1206612,0.00008285,99.96975792
4657,裰,衣,14,1,1206613,0.00008285,99.96984077
4658,暘,日,13,1,1206614,0.00008285,99.96992362
4659,撂,手,14,1,1206615,0.00008285,99.97000647
4660,塚,土,13,1,1206616,0.00008285,99.97008932
4661,榖,木,14,1,1206617,0.00008285,99.97017217
4662,馭,馬,12,1,1206618,0.00008285,99.97025502
4663,潁,水,15,1,1206619,0.00008285,99.97033787
4664,渥,水,12,1,1206620,0.00008285,99.97042072
4665,徫,彳,12,1,1206621,0.00008285,99.97050357
4666,棻,木,12,1,1206622,0.00008285,99.97058642
4667,潢,水,15,1,1206623,0.00008285,99.97066927
4668,幗,巾,14,1,1206624,0.00008285,99.97075212
4669,銎,金,14,1,1206625,0.00008285,99.97083497
4670,嶄,山,14,1,1206626,0.00008285,99.97091782
4671,觚,角,12,1,1206627,0.00008285,99.97100067
4672,遐,ひ,13,1,1206628,0.00008285,99.97108352
4673,儆,人,15,1,1206629,0.00008285,99.97116637
4674,逾,ひ,13,1,1206630,0.00008285,99.97124922
4675,璉,玉,15,1,1206631,0.00008285,99.97133207
4676,葷,艸,13,1,1206632,0.00008285,99.97141492
4677,瞍,目,15,1,1206633,0.00008285,99.97149777
4678,漾,水,14,1,1206634,0.00008285,99.97158062
4679,酚,酉,11,1,1206635,0.00008285,99.97166347
4680,暝,日,14,1,1206636,0.00008285,99.97174632
4681,魟,魚,14,1,1206637,0.00008285,99.97182917
4682,賂,貝,13,1,1206638,0.00008285,99.97191202
4683,瞅,目,14,1,1206639,0.00008285,99.97199487
4684,瑣,玉,14,1,1206640,0.00008285,99.97207772
4685,頎,頁,13,1,1206641,0.00008285,99.97216057
4686,鈷,金,13,1,1206642,0.00008285,99.97224342
4687,蓽,艸,15,1,1206643,0.00008285,99.97232627
4688,稞,禾,13,1,1206644,0.00008285,99.97240912
4689,蔞,艸,15,1,1206645,0.00008285,99.97249197
4690,鈽,金,13,1,1206646,0.00008285,99.97257482
4691,蝟,虫,15,1,1206647,0.00008285,99.97265767
4692,艋,舟,14,1,1206648,0.00008285,99.97274052
4693,褙,衣,15,1,1206649,0.00008285,99.97282337
4694,鉋,金,13,1,1206650,0.00008285,99.97290622
4695,舺,舟,11,1,1206651,0.00008285,99.97298907
4696,蓊,艸,14,1,1206652,0.00008285,99.97307192
4697,眥,目,11,1,1206653,0.00008285,99.97315477
4698,犒,牛,14,1,1206654,0.00008285,99.97323762
4699,瑢,玉,14,1,1206655,0.00008285,99.97332047
4700,痳,ば,13,1,1206656,0.00008285,99.97340332
4701,腊,肉,12,1,1206657,0.00008285,99.97348617
4702,粵,米,13,1,1206658,0.00008285,99.97356902
4703,閫,門,15,1,1206659,0.00008285,99.97365187
4704,瘀,ば,13,1,1206660,0.00008285,99.97373472
4705,萣,艸,12,1,1206661,0.00008285,99.97381757
4706,蜩,虫,14,1,1206662,0.00008285,99.97390042
4707,滸,水,14,1,1206663,0.00008285,99.97398327
4708,僖,人,14,1,1206664,0.00008285,99.97406612
4709,噀,口,15,1,1206665,0.00008285,99.97414897
4710,貲,貝,13,1,1206666,0.00008285,99.97423182
4711,琄,玉,11,1,1206667,0.00008285,99.97431467
4712,墀,土,15,1,1206668,0.00008285,99.97439752
4713,嬃,女,15,1,1206669,0.00008285,99.97448037
4714,憎,心,15,1,1206670,0.00008285,99.97456322
4715,圜,囗,16,1,1206671,0.00008285,99.97464607
4716,撚,手,15,1,1206672,0.00008285,99.97472892
4717,嶙,山,15,1,1206673,0.00008285,99.97481177
4718,冪,だ,16,1,1206674,0.00008285,99.97489462
4719,淖,水,11,1,1206675,0.00008285,99.97497747
4720,慝,心,15,1,1206676,0.00008285,99.97506032
4721,淩,水,11,1,1206677,0.00008285,99.97514317
4722,頜,頁,15,1,1206678,0.00008285,99.97522602
4723,摰,手,15,1,1206679,0.00008285,99.97530887
4724,韶,音,14,1,1206680,0.00008285,99.97539172
4725,靳,革,13,1,1206681,0.00008285,99.97547457
4726,噤,口,16,1,1206682,0.00008285,99.97555742
4727,槲,木,15,1,1206683,0.00008285,99.97564027
4728,鄞,邑,14,1,1206684,0.00008285,99.97572312
4729,葯,艸,13,1,1206685,0.00008285,99.97580597
4730,蔑,艸,15,1,1206686,0.00008285,99.97588882
4731,螓,虫,16,1,1206687,0.00008285,99.97597167
4732,遛,ひ,14,1,1206688,0.00008285,99.97605452
4733,彀,弓,13,1,1206689,0.00008285,99.97613737
4734,赭,赤,15,1,1206690,0.00008285,99.97622022
4735,蒍,艸,13,1,1206691,0.00008285,99.97630307
4736,頫,頁,15,1,1206692,0.00008285,99.97638592
4737,槿,木,15,1,1206693,0.00008285,99.97646877
4738,劊,刀,15,1,1206694,0.00008285,99.97655162
4739,扙,手,6,1,1206695,0.00008285,99.97663447
4740,潼,水,15,1,1206696,0.00008285,99.97671732
4741,遶,ひ,16,1,1206697,0.00008285,99.97680017
4742,懣,心,18,1,1206698,0.00008285,99.97688302
4743,錛,金,16,1,1206699,0.00008285,99.97696587
4744,踹,足,16,1,1206700,0.00008285,99.97704872
4745,錩,金,16,1,1206701,0.00008285,99.97713157
4746,賸,貝,17,1,1206702,0.00008285,99.97721442
4747,閹,門,16,1,1206703,0.00008285,99.97729727
4748,鍚,金,17,1,1206704,0.00008285,99.97738012
4749,僉,人,13,1,1206705,0.00008285,99.97746297
4750,孺,子,17,1,1206706,0.00008285,99.97754582
4751,鮐,魚,16,1,1206707,0.00008285,99.97762867
4752,覦,見,16,1,1206708,0.00008285,99.97771152
4753,梇,木,11,1,1206709,0.00008285,99.97779437
4754,駢,馬,16,1,1206710,0.00008285,99.97787722
4755,鴝,鳥,16,1,1206711,0.00008285,99.97796007
4756,縈,糸,16,1,1206712,0.00008285,99.97804292
4757,晢,日,11,1,1206713,0.00008285,99.97812577
4758,殮,歹,17,1,1206714,0.00008285,99.97820862
4759,詒,言,12,1,1206715,0.00008285,99.97829147
4760,瀋,水,18,1,1206716,0.00008285,99.97837432
4761,殭,歹,17,1,1206717,0.00008285,99.97845717
4762,鍥,金,17,1,1206718,0.00008285,99.97854002
4763,澔,水,15,1,1206719,0.00008285,99.97862287
4764,蹊,足,17,1,1206720,0.00008285,99.97870572
4765,喏,口,12,1,1206721,0.00008285,99.97878857
4766,曙,日,17,1,1206722,0.00008285,99.97887142
4767,碇,石,13,1,1206723,0.00008285,99.97895427
4768,盥,皿,16,1,1206724,0.00008285,99.97903712
4769,睚,目,13,1,1206725,0.00008285,99.97911997
4770,濠,水,17,1,1206726,0.00008285,99.97920282
4771,罅,缶,17,1,1206727,0.00008285,99.97928567
4772,錨,金,17,1,1206728,0.00008285,99.97936852
4773,緡,糸,15,1,1206729,0.00008285,99.97945137
4774,醣,酉,17,1,1206730,0.00008285,99.97953422
4775,崚,山,11,1,1206731,0.00008285,99.97961707
4776,濬,水,17,1,1206732,0.00008285,99.97969992
4777,婕,女,11,1,1206733,0.00008285,99.97978277
4778,邂,ひ,17,1,1206734,0.00008285,99.97986562
4779,乜,乙,2,1,1206735,0.00008285,99.97994847
4780,瞼,目,18,1,1206736,0.00008285,99.98003132
4781,襁,衣,17,1,1206737,0.00008285,99.98011417
4782,遽,ひ,17,1,1206738,0.00008285,99.98019702
4783,謖,言,17,1,1206739,0.00008285,99.98027987
4784,檻,木,18,1,1206740,0.00008285,99.98036272
4785,偲,人,11,1,1206741,0.00008285,99.98044557
4786,篠,竹,17,1,1206742,0.00008285,99.98052842
4787,陟,阜,10,1,1206743,0.00008285,99.98061127
4788,薊,艸,17,1,1206744,0.00008285,99.98069412
4789,蓴,艸,15,1,1206745,0.00008285,99.98077697
4790,驍,馬,22,1,1206746,0.00008285,99.98085982
4791,隰,阜,17,1,1206747,0.00008285,99.98094267
4792,矓,目,21,1,1206748,0.00008285,99.98102552
4793,荇,艸,10,1,1206749,0.00008285,99.98110837
4794,囈,口,22,1,1206750,0.00008285,99.98119122
4795,鋯,金,15,1,1206751,0.00008285,99.98127407
4796,鐳,金,21,1,1206752,0.00008285,99.98135692
4797,茛,艸,10,1,1206753,0.00008285,99.98143977
4798,譴,言,21,1,1206754,0.00008285,99.98152262
4799,謾,言,18,1,1206755,0.00008285,99.98160547
4800,蟯,虫,18,1,1206756,0.00008285,99.98168832
4801,嚙,口,18,1,1206757,0.00008285,99.98177117
4802,韜,韋,19,1,1206758,0.00008285,99.98185402
4803,网,网,6,1,1206759,0.00008285,99.98193687
4804,驃,馬,21,1,1206760,0.00008285,99.98201972
4805,燿,火,18,1,1206761,0.00008285,99.98210257
4806,鵠,鳥,18,1,1206762,0.00008285,99.98218542
4807,蟳,虫,18,1,1206763,0.00008285,99.98226827
4808,贛,貝,24,1,1206764,0.00008285,99.98235112
4809,黿,黽,17,1,1206765,0.00008285,99.98243397
4810,謨,言,18,1,1206766,0.00008285,99.98251682
4811,瀅,水,18,1,1206767,0.00008285,99.98259967
4812,蟠,虫,18,1,1206768,0.00008285,99.98268252
4813,癤,ば,18,1,1206769,0.00008285,99.98276537
4814,顰,頁,24,1,1206770,0.00008285,99.98284822
4815,笈,竹,10,1,1206771,0.00008285,99.98293107
4816,瀘,水,19,1,1206772,0.00008285,99.98301392
4817,砱,石,10,1,1206773,0.00008285,99.98309677
4818,齜,齒,21,1,1206774,0.00008285,99.98317962
4819,蹔,足,18,1,1206775,0.00008285,99.98326247
4820,齧,齒,21,1,1206776,0.00008285,99.98334532
4821,砣,石,10,1,1206777,0.00008285,99.98342817
4822,鶉,鳥,19,1,1206778,0.00008285,99.98351102
4823,珣,玉,10,1,1206779,0.00008285,99.98359387
4824,馥,香,18,1,1206780,0.00008285,99.98367672
4825,閬,門,15,1,1206781,0.00008285,99.98375957
4826,邇,ひ,18,1,1206782,0.00008285,99.98384242
4827,騅,馬,18,1,1206783,0.00008285,99.98392527
4828,孿,子,22,1,1206784,0.00008285,99.98400812
4829,眭,目,11,1,1206785,0.00008285,99.98409097
4830,霰,雨,20,1,1206786,0.00008285,99.98417382
4831,珥,玉,10,1,1206787,0.00008285,99.98425667
4832,甯,用,12,1,1206788,0.00008285,99.98433952
4833,鵟,鳥,18,1,1206789,0.00008285,99.98442237
4834,焙,火,12,1,1206790,0.00008285,99.98450522
4835,鼩,鼠,18,1,1206791,0.00008285,99.98458807
4836,閑,門,12,1,1206792,0.00008285,99.98467092
4837,厴,厂,19,1,1206793,0.00008285,99.98475377
4838,隄,阜,12,1,1206794,0.00008285,99.98483662
4839,涘,水,10,1,1206795,0.00008285,99.98491947
4840,嗣,口,13,1,1206796,0.00008285,99.98500232
4841,嬿,女,19,1,1206797,0.00008285,99.98508517
4842,滇,水,13,1,1206798,0.00008285,99.98516802
4843,櫧,木,19,1,1206799,0.00008285,99.98525087
4844,賄,貝,13,1,1206800,0.00008285,99.98533372
4845,烷,火,11,1,1206801,0.00008285,99.98541657
4846,貉,豸,13,1,1206802,0.00008285,99.98549942
4847,桎,木,10,1,1206803,0.00008285,99.98558227
4848,旖,方,14,1,1206804,0.00008285,99.98566512
4849,捅,手,10,1,1206805,0.00008285,99.98574797
4850,酩,酉,13,1,1206806,0.00008285,99.98583082
4851,穨,禾,19,1,1206807,0.00008285,99.98591367
4852,嫣,女,14,1,1206808,0.00008285,99.98599652
4853,糬,米,19,1,1206809,0.00008285,99.98607937
4854,筮,竹,13,1,1206810,0.00008285,99.98616222
4855,嗐,口,13,1,1206811,0.00008285,99.98624507
4856,蓀,艸,14,1,1206812,0.00008285,99.98632792
4857,哧,口,10,1,1206813,0.00008285,99.98641077
4858,睪,目,13,1,1206814,0.00008285,99.98649362
4859,埕,土,10,1,1206815,0.00008285,99.98657647
4860,隘,阜,13,1,1206816,0.00008285,99.98665932
4861,蹭,足,19,1,1206817,0.00008285,99.98674217
4862,靶,革,13,1,1206818,0.00008285,99.98682502
4863,鏄,金,19,1,1206819,0.00008285,99.98690787
4864,睿,目,14,1,1206820,0.00008285,99.98699072
4865,娳,女,10,1,1206821,0.00008285,99.98707357
4866,緘,糸,15,1,1206822,0.00008285,99.98715642
4867,耷,耳,9,1,1206823,0.00008285,99.98723927
4868,霆,雨,15,1,1206824,0.00008285,99.98732212
4869,鯔,魚,19,1,1206825,0.00008285,99.98740497
4870,慫,心,15,1,1206826,0.00008285,99.98748782
4871,鶆,鳥,19,1,1206827,0.00008285,99.98757067
4872,箴,竹,15,1,1206828,0.00008285,99.98765352
4873,紈,糸,9,1,1206829,0.00008285,99.98773637
4874,滕,水,15,1,1206830,0.00008285,99.98781922
4875,鵯,鳥,19,1,1206831,0.00008285,99.98790207
4876,犛,牛,15,1,1206832,0.00008285,99.98798492
4877,鱸,魚,27,1,1206833,0.00008285,99.98806777
4878,褓,衣,15,1,1206834,0.00008285,99.98815062
4879,曣,日,20,1,1206835,0.00008285,99.98823347
4880,諍,言,15,1,1206836,0.00008285,99.98831632
4881,淀,水,11,1,1206837,0.00008285,99.98839917
4882,嶸,山,17,1,1206838,0.00008285,99.98848202
4883,藿,艸,20,1,1206839,0.00008285,99.98856487
4884,鴛,鳥,16,1,1206840,0.00008285,99.98864772
4885,蘄,艸,20,1,1206841,0.00008285,99.98873057
4886,壕,土,17,1,1206842,0.00008285,99.98881342
4887,嗔,口,13,1,1206843,0.00008285,99.98889627
4888,鴦,鳥,16,1,1206844,0.00008285,99.98897912
4889,蠖,虫,20,1,1206845,0.00008285,99.98906197
4890,縊,糸,16,1,1206846,0.00008285,99.98914482
4891,籸,米,9,1,1206847,0.00008285,99.98922767
4892,罄,缶,17,1,1206848,0.00008285,99.98931052
4893,螗,虫,16,1,1206849,0.00008285,99.98939337
4894,鍍,金,17,1,1206850,0.00008285,99.98947622
4895,眄,目,9,1,1206851,0.00008285,99.98955907
4896,瞟,目,16,1,1206852,0.00008285,99.98964192
4897,螅,虫,16,1,1206853,0.00008285,99.98972477
4898,癘,ば,18,1,1206854,0.00008285,99.98980762
4899,鰆,魚,20,1,1206855,0.00008285,99.98989047
4900,蹉,足,17,1,1206856,0.00008285,99.98997332
4901,洄,水,9,1,1206857,0.00008285,99.99005617
4902,臃,肉,17,1,1206858,0.00008285,99.99013902
4903,鶿,鳥,20,1,1206859,0.00008285,99.99022187
4904,餞,食,16,1,1206860,0.00008285,99.99030472
4905,鶩,鳥,20,1,1206861,0.00008285,99.99038757
4906,壟,土,19,1,1206862,0.00008285,99.99047042
4907,櫸,木,21,1,1206863,0.00008285,99.99055327
4908,齪,齒,22,1,1206864,0.00008285,99.99063612
4909,洨,水,9,1,1206865,0.00008285,99.99071897
4910,灞,水,24,1,1206866,0.00008285,99.99080182
4911,毖,比,9,1,1206867,0.00008285,99.99088467
4912,鐫,金,20,1,1206868,0.00008285,99.99096752
4913,螈,虫,16,1,1206869,0.00008285,99.99105037
4914,騵,馬,20,1,1206870,0.00008285,99.99113322
4915,鸞,鳥,30,1,1206871,0.00008285,99.99121607
4916,醮,酉,19,1,1206872,0.00008285,99.99129892
4917,殂,歹,9,1,1206873,0.00008285,99.99138177
4918,瓚,玉,23,1,1206874,0.00008285,99.99146462
4919,鶺,鳥,21,1,1206875,0.00008285,99.99154747
4920,鬃,髟,18,1,1206876,0.00008285,99.99163032
4921,鼱,鼠,21,1,1206877,0.00008285,99.99171317
4922,覲,見,18,1,1206878,0.00008285,99.99179602
4923,攢,手,22,1,1206879,0.00008285,99.99187887
4924,纓,糸,23,1,1206880,0.00008285,99.99196172
4925,暐,日,13,1,1206881,0.00008285,99.99204457
4926,琬,玉,12,1,1206882,0.00008285,99.99212742
4927,梏,木,11,1,1206883,0.00008285,99.99221027
4928,摒,手,12,1,1206884,0.00008285,99.99229312
4929,恂,心,9,1,1206885,0.00008285,99.99237597
4930,酣,酉,12,1,1206886,0.00008285,99.99245882
4931,糴,米,22,1,1206887,0.00008285,99.99254167
4932,跎,足,12,1,1206888,0.00008285,99.99262452
4933,驊,馬,22,1,1206889,0.00008285,99.99270737
4934,蜃,虫,13,1,1206890,0.00008285,99.99279022
4935,鱈,魚,22,1,1206891,0.00008285,99.99287307
4936,幛,巾,14,1,1206892,0.00008285,99.99295592
4937,扃,戶,9,1,1206893,0.00008285,99.99303877
4938,嫗,女,14,1,1206894,0.00008285,99.99312162
4939,躕,足,22,1,1206895,0.00008285,99.99320447
4940,鉑,金,13,1,1206896,0.00008285,99.99328732
4941,峋,山,9,1,1206897,0.00008285,99.99337017
4942,髡,髟,13,1,1206898,0.00008285,99.99345302
4943,攥,手,23,1,1206899,0.00008285,99.99353587
4944,壅,土,16,1,1206900,0.00008285,99.99361872
4945,屌,尸,9,1,1206901,0.00008285,99.99370157
4946,銼,金,15,1,1206902,0.00008285,99.99378442
4947,轤,車,23,1,1206903,0.00008285,99.99386727
4948,踟,足,15,1,1206904,0.00008285,99.99395012
4949,姮,女,9,1,1206905,0.00008285,99.99403297
4950,誑,言,14,1,1206906,0.00008285,99.99411582
4951,濨,水,16,1,1206907,0.00008285,99.99419867
4952,攆,手,18,1,1206908,0.00008285,99.99428152
4953,芫,艸,8,1,1206909,0.00008285,99.99436437
4954,錚,金,16,1,1206910,0.00008285,99.99444722
4955,坌,土,7,1,1206911,0.00008285,99.99453007
4956,鴒,鳥,16,1,1206912,0.00008285,99.99461292
4957,顴,頁,27,1,1206913,0.00008285,99.99469577
4958,燾,火,18,1,1206914,0.00008285,99.99477862
4959,剉,刀,9,1,1206915,0.00008285,99.99486147
4960,瞽,目,18,1,1206916,0.00008285,99.99494432
4961,鷿,鳥,24,1,1206917,0.00008285,99.99502717
4962,縹,糸,17,1,1206918,0.00008285,99.99511002
4963,糶,米,25,1,1206919,0.00008285,99.99519287
4964,贍,貝,20,1,1206920,0.00008285,99.99527572
4965,妏,女,7,1,1206921,0.00008285,99.99535857
4966,囌,口,23,1,1206922,0.00008285,99.99544142
4967,俬,人,9,1,1206923,0.00008285,99.99552427
4968,鏃,金,19,1,1206924,0.00008285,99.99560712
4969,鸕,鳥,27,1,1206925,0.00008285,99.99568997
4970,孽,子,20,1,1206926,0.00008285,99.99577282
4971,玠,玉,8,1,1206927,0.00008285,99.99585567
4972,繕,糸,18,1,1206928,0.00008285,99.99593852
4973,欞,木,28,1,1206929,0.00008285,99.99602137
4974,蜣,虫,14,1,1206930,0.00008285,99.99610422
4975,鱺,魚,30,1,1206931,0.00008285,99.99618707
4976,氬,气,12,1,1206932,0.00008285,99.99626992
4977,炔,火,8,1,1206933,0.00008285,99.99635277
4978,箋,竹,14,1,1206934,0.00008285,99.99643562
4979,瑗,玉,13,1,1206935,0.00008285,99.99651847
4980,睨,目,13,1,1206936,0.00008285,99.99660132
4981,泂,水,8,1,1206937,0.00008285,99.99668417
4982,賃,貝,13,1,1206938,0.00008285,99.99676702
4983,枒,木,8,1,1206939,0.00008285,99.99684987
4984,鉻,金,14,1,1206940,0.00008285,99.99693272
4985,崌,山,11,1,1206941,0.00008285,99.99701557
4986,癆,ば,17,1,1206942,0.00008285,99.99709842
4987,嫺,女,15,1,1206943,0.00008285,99.99718127
4988,縑,糸,16,1,1206944,0.00008285,99.99726412
4989,扠,手,6,1,1206945,0.00008285,99.99734697
4990,覬,見,17,1,1206946,0.00008285,99.99742982
4991,豸,豸,7,1,1206947,0.00008285,99.99751267
4992,獺,犬,19,1,1206948,0.00008285,99.99759552
4993,岬,山,8,1,1206949,0.00008285,99.99767837
4994,霪,雨,19,1,1206950,0.00008285,99.99776122
4995,夌,,8,1,1206951,0.00008285,99.99784407
4996,齷,齒,24,1,1206952,0.00008285,99.99792692
4997,咂,口,8,1,1206953,0.00008285,99.99800977
4998,愷,心,13,1,1206954,0.00008285,99.99809262
4999,冼,ち,8,1,1206955,0.00008285,99.99817547
5000,榷,木,14,1,1206956,0.00008285,99.99825832
5002,緲,糸,15,1,1206958,0.00008285,99.99842402
5004,糠,米,17,1,1206960,0.00008285,99.99858972
5005,玕,玉,7,1,1206961,0.00008285,99.99867257
5006,濰,水,17,1,1206962,0.00008285,99.99875542
5008,鷂,鳥,21,1,1206964,0.00008285,99.99892112
5010,綬,糸,14,1,1206966,0.00008285,99.99908682
5011,汩,水,7,1,1206967,0.00008285,99.99916967
5012,褊,衣,15,1,1206968,0.00008285,99.99925252
5013,蘚,艸,21,1,1206969,0.00008285,99.99933537
5014,餾,食,18,1,1206970,0.00008285,99.99941822
5015,摑,手,14,1,1206971,0.00008285,99.99950107
5016,臆,肉,17,1,1206972,0.00008285,99.99958392
5017,粿,米,14,1,1206973,0.00008285,99.99966677
5018,緋,糸,14,1,1206974,0.00008285,99.99974962